"","INDEX","X2000","X2087","change","EEZID"
"1",82205,93,81,-12,945
"2",82206,90,80,-10,945
"3",82924,67,54,-13,945
"4",82925,41,37,-4,945
"5",82926,160,149,-11,945
"6",82927,150,137,-13,945
"7",83644,24,20,-4,945
"8",83645,27,26,-1,945
"9",83646,40,38,-2,945
"10",83647,39,36,-3,945
"11",83651,137,129,-8,945
"12",83652,138,129,-9,945
"13",83653,138,129,-9,945
"14",84362,28,22,-6,945
"15",84363,29,21,-8,945
"16",84364,29,21,-8,945
"17",84365,21,20,-1,945
"18",84366,23,23,0,945
"19",84367,153,146,-7,945
"20",84368,149,144,-5,945
"21",84371,159,148,-11,945
"22",84372,161,151,-10,945
"23",84373,161,150,-11,945
"24",84374,161,150,-11,945
"25",85077,15,14,-1,945
"26",85078,16,14,-2,945
"27",85079,13,13,0,945
"28",85080,13,13,0,945
"29",85081,16,13,-3,945
"30",85082,18,14,-4,945
"31",85083,19,15,-4,945
"32",85084,19,15,-4,945
"33",85085,28,28,0,945
"34",85086,28,29,1,945
"35",85087,33,35,2,945
"36",85088,87,85,-2,945
"37",85091,143,133,-10,945
"38",85092,156,143,-13,945
"39",85093,136,121,-15,945
"40",85094,159,140,-19,945
"41",85095,118,95,-23,945
"42",85796,15,15,0,945
"43",85797,15,14,-1,945
"44",85798,15,14,-1,945
"45",85799,13,13,0,945
"46",85800,14,14,0,945
"47",85801,16,13,-3,945
"48",85802,16,13,-3,945
"49",85803,17,13,-4,945
"50",85804,18,14,-4,945
"51",85805,27,27,0,945
"52",85806,27,29,2,945
"53",85807,29,31,2,945
"54",85808,164,164,0,945
"55",85809,163,162,-1,945
"56",85811,158,149,-9,945
"57",85812,170,159,-11,945
"58",85813,123,108,-15,945
"59",85814,153,138,-15,945
"60",85815,144,133,-11,945
"61",86516,15,14,-1,945
"62",86517,14,14,0,945
"63",86518,14,14,0,945
"64",86519,15,14,-1,945
"65",86520,15,14,-1,945
"66",86521,16,14,-2,945
"67",86522,16,14,-2,945
"68",86523,18,13,-5,945
"69",86524,18,14,-4,945
"70",86525,26,28,2,945
"71",86526,35,36,1,945
"72",86527,43,45,2,945
"73",86528,53,55,2,945
"74",86529,160,157,-3,945
"75",86530,146,142,-4,945
"76",86532,160,148,-12,945
"77",86533,164,149,-15,945
"78",86534,162,149,-13,945
"79",86535,159,148,-11,945
"80",86536,129,122,-7,945
"81",87236,15,14,-1,945
"82",87237,15,14,-1,945
"83",87238,15,14,-1,945
"84",87239,15,14,-1,945
"85",87240,15,14,-1,945
"86",87241,16,14,-2,945
"87",87242,16,14,-2,945
"88",87243,19,14,-5,945
"89",87244,24,23,-1,945
"90",87245,27,28,1,945
"91",87246,30,32,2,945
"92",87247,38,40,2,945
"93",87248,41,44,3,945
"94",87249,122,121,-1,945
"95",87250,163,163,0,945
"96",87251,158,156,-2,945
"97",87253,157,147,-10,945
"98",87254,160,147,-13,945
"99",87255,122,108,-14,945
"100",87256,112,101,-11,945
"101",87956,15,14,-1,945
"102",87957,15,14,-1,945
"103",87958,16,14,-2,945
"104",87959,16,14,-2,945
"105",87960,16,14,-2,945
"106",87961,18,14,-4,945
"107",87962,18,14,-4,945
"108",87963,24,17,-7,945
"109",87964,24,23,-1,945
"110",87965,26,26,0,945
"111",87966,26,28,2,945
"112",87967,26,27,1,945
"113",87968,31,33,2,945
"114",87969,83,77,-6,945
"115",87970,124,114,-10,945
"116",87971,151,143,-8,945
"117",87972,147,138,-9,945
"118",87974,151,143,-8,945
"119",87975,157,146,-11,945
"120",87976,152,146,-6,945
"121",87977,136,128,-8,945
"122",88676,14,14,0,945
"123",88677,15,14,-1,945
"124",88678,17,14,-3,945
"125",88679,17,14,-3,945
"126",88680,17,14,-3,945
"127",88681,18,14,-4,945
"128",88682,19,14,-5,945
"129",88683,24,17,-7,945
"130",88684,25,17,-8,945
"131",88685,25,25,0,945
"132",88686,26,25,-1,945
"133",88687,26,27,1,945
"134",88688,26,26,0,945
"135",88689,164,157,-7,945
"136",88690,163,157,-6,945
"137",88691,158,148,-10,945
"138",88692,155,143,-12,945
"139",88695,143,133,-10,945
"140",88696,142,134,-8,945
"141",88697,152,144,-8,945
"142",88698,149,140,-9,945
"143",89397,19,20,1,945
"144",89398,20,20,0,945
"145",89399,21,19,-2,945
"146",89400,24,19,-5,945
"147",89401,24,20,-4,945
"148",89402,24,20,-4,945
"149",89403,24,22,-2,945
"150",89404,25,22,-3,945
"151",89405,25,22,-3,945
"152",89406,25,22,-3,945
"153",89407,25,23,-2,945
"154",89408,26,23,-3,945
"155",89409,79,68,-11,945
"156",89410,157,147,-10,945
"157",89411,153,145,-8,945
"158",89412,138,130,-8,945
"159",89413,81,78,-3,945
"160",89415,145,144,-1,945
"161",89416,147,147,0,945
"162",89417,59,48,-11,945
"163",89418,151,146,-5,945
"164",89419,148,144,-4,945
"165",90117,19,20,1,945
"166",90118,19,20,1,945
"167",90119,22,19,-3,945
"168",90120,23,19,-4,945
"169",90121,24,20,-4,945
"170",90122,24,20,-4,945
"171",90123,24,22,-2,945
"172",90124,25,22,-3,945
"173",90125,25,22,-3,945
"174",90126,25,22,-3,945
"175",90127,25,22,-3,945
"176",90128,26,23,-3,945
"177",90129,28,23,-5,945
"178",90130,35,29,-6,945
"179",90131,148,145,-3,945
"180",90132,149,144,-5,945
"181",90136,146,143,-3,945
"182",90137,146,143,-3,945
"183",90138,29,17,-12,945
"184",90139,148,143,-5,945
"185",90140,147,141,-6,945
"186",90141,105,105,0,945
"187",90838,19,22,3,945
"188",90839,22,22,0,945
"189",90840,23,22,-1,945
"190",90841,25,22,-3,945
"191",90842,25,22,-3,945
"192",90843,25,22,-3,945
"193",90844,25,22,-3,945
"194",90845,24,22,-2,945
"195",90846,26,22,-4,945
"196",90847,26,22,-4,945
"197",90848,27,22,-5,945
"198",90849,25,21,-4,945
"199",90850,25,21,-4,945
"200",90851,28,17,-11,945
"201",90852,118,110,-8,945
"202",90853,133,127,-6,945
"203",90854,129,124,-5,945
"204",90855,104,101,-3,945
"205",90857,147,143,-4,945
"206",90858,152,145,-7,945
"207",90859,32,20,-12,945
"208",90860,140,132,-8,945
"209",90861,139,131,-8,945
"210",90862,122,114,-8,945
"211",91559,22,22,0,945
"212",91560,24,22,-2,945
"213",91561,24,22,-2,945
"214",91562,25,22,-3,945
"215",91563,25,22,-3,945
"216",91564,25,22,-3,945
"217",91565,24,22,-2,945
"218",91566,24,22,-2,945
"219",91567,26,22,-4,945
"220",91568,26,22,-4,945
"221",91569,26,21,-5,945
"222",91570,27,22,-5,945
"223",91571,27,16,-11,945
"224",91572,27,15,-12,945
"225",91573,120,112,-8,945
"226",91574,118,112,-6,945
"227",91575,126,119,-7,945
"228",91576,114,110,-4,945
"229",91578,106,90,-16,945
"230",91579,105,92,-13,945
"231",91580,37,25,-12,945
"232",91581,135,131,-4,945
"233",91582,129,125,-4,945
"234",92280,21,22,1,945
"235",92281,22,22,0,945
"236",92282,24,22,-2,945
"237",92283,23,22,-1,945
"238",92284,24,22,-2,945
"239",92285,24,22,-2,945
"240",92286,26,22,-4,945
"241",92287,26,22,-4,945
"242",92288,26,22,-4,945
"243",92289,24,20,-4,945
"244",92290,25,20,-5,945
"245",92291,22,14,-8,945
"246",92292,22,14,-8,945
"247",92293,36,26,-10,945
"248",92294,80,73,-7,945
"249",92295,127,122,-5,945
"250",92296,124,118,-6,945
"251",92298,130,129,-1,945
"252",92299,136,133,-3,945
"253",92300,36,32,-4,945
"254",92301,107,102,-5,945
"255",92302,129,126,-3,945
"256",92303,81,80,-1,945
"257",93002,23,23,0,945
"258",93003,23,22,-1,945
"259",93004,24,22,-2,945
"260",93005,25,22,-3,945
"261",93006,26,22,-4,945
"262",93007,26,22,-4,945
"263",93008,26,22,-4,945
"264",93009,24,20,-4,945
"265",93010,25,20,-5,945
"266",93011,21,14,-7,945
"267",93012,21,14,-7,945
"268",93013,27,20,-7,945
"269",93014,71,61,-10,945
"270",93015,113,107,-6,945
"271",93016,110,107,-3,945
"272",93019,82,78,-4,945
"273",93020,82,78,-4,945
"274",93021,23,19,-4,945
"275",93022,130,127,-3,945
"276",93023,127,125,-2,945
"277",93024,120,118,-2,945
"278",93722,22,22,0,945
"279",93723,22,22,0,945
"280",93724,23,22,-1,945
"281",93725,24,22,-2,945
"282",93726,23,22,-1,945
"283",93727,23,20,-3,945
"284",93728,23,20,-3,945
"285",93729,24,21,-3,945
"286",93730,24,21,-3,945
"287",93731,25,14,-11,945
"288",93732,26,14,-12,945
"289",93733,26,21,-5,945
"290",93734,29,23,-6,945
"291",93735,83,79,-4,945
"292",93736,124,121,-3,945
"293",93737,121,119,-2,945
"294",93739,122,122,0,945
"295",93740,126,123,-3,945
"296",93741,43,36,-7,945
"297",93742,28,24,-4,945
"298",93743,87,82,-5,945
"299",93744,129,124,-5,945
"300",93745,112,111,-1,945
"301",94442,21,22,1,945
"302",94443,21,22,1,945
"303",94444,22,22,0,945
"304",94445,24,22,-2,945
"305",94446,23,22,-1,945
"306",94447,21,20,-1,945
"307",94448,23,20,-3,945
"308",94449,24,21,-3,945
"309",94450,24,21,-3,945
"310",94451,25,14,-11,945
"311",94452,26,14,-12,945
"312",94453,25,22,-3,945
"313",94454,25,23,-2,945
"314",94455,29,29,0,945
"315",94456,84,81,-3,945
"316",94457,121,120,-1,945
"317",94458,121,119,-2,945
"318",94459,120,117,-3,945
"319",94460,121,121,0,945
"320",94461,120,119,-1,945
"321",94462,46,41,-5,945
"322",94463,28,23,-5,945
"323",94464,107,103,-4,945
"324",94465,118,117,-1,945
"325",94466,109,108,-1,945
"326",95162,20,22,2,945
"327",95163,20,22,2,945
"328",95164,20,22,2,945
"329",95165,21,20,-1,945
"330",95166,21,20,-1,945
"331",95167,22,21,-1,945
"332",95168,22,21,-1,945
"333",95169,23,21,-2,945
"334",95170,23,21,-2,945
"335",95171,24,14,-10,945
"336",95172,24,14,-10,945
"337",95173,24,21,-3,945
"338",95174,25,21,-4,945
"339",95175,26,24,-2,945
"340",95176,62,57,-5,945
"341",95177,73,69,-4,945
"342",95178,75,66,-9,945
"343",95179,119,116,-3,945
"344",95180,112,111,-1,945
"345",95181,119,119,0,945
"346",95182,118,116,-2,945
"347",95183,25,22,-3,945
"348",95184,31,27,-4,945
"349",95185,92,89,-3,945
"350",95186,121,119,-2,945
"351",95187,109,109,0,945
"352",95882,19,21,2,945
"353",95883,20,22,2,945
"354",95884,20,22,2,945
"355",95885,21,20,-1,945
"356",95886,21,20,-1,945
"357",95887,22,21,-1,945
"358",95888,22,21,-1,945
"359",95889,22,21,-1,945
"360",95890,23,21,-2,945
"361",95891,24,14,-10,945
"362",95892,24,14,-10,945
"363",95893,24,21,-3,945
"364",95894,25,22,-3,945
"365",95895,25,23,-2,945
"366",95896,25,23,-2,945
"367",95897,36,33,-3,945
"368",95898,38,36,-2,945
"369",95899,66,57,-9,945
"370",95900,117,114,-3,945
"371",95901,114,110,-4,945
"372",95902,115,112,-3,945
"373",95903,26,21,-5,945
"374",95904,25,20,-5,945
"375",95905,24,22,-2,945
"376",95906,68,62,-6,945
"377",95907,121,114,-7,945
"378",95908,114,108,-6,945
"379",96603,17,20,3,945
"380",96604,19,21,2,945
"381",96605,21,21,0,945
"382",96606,22,21,-1,945
"383",96607,22,21,-1,945
"384",96608,22,21,-1,945
"385",96609,21,14,-7,945
"386",96610,22,14,-8,945
"387",96611,24,14,-10,945
"388",96612,24,14,-10,945
"389",96613,24,22,-2,945
"390",96614,25,22,-3,945
"391",96615,25,22,-3,945
"392",96616,25,22,-3,945
"393",96617,23,20,-3,945
"394",96618,23,20,-3,945
"395",96619,26,22,-4,945
"396",96620,112,108,-4,945
"397",96621,112,108,-4,945
"398",96622,39,36,-3,945
"399",96623,23,21,-2,945
"400",96624,23,21,-2,945
"401",96625,27,25,-2,945
"402",96626,27,25,-2,945
"403",96627,65,58,-7,945
"404",96628,115,111,-4,945
"405",96629,106,103,-3,945
"406",97324,15,19,4,945
"407",97325,19,20,1,945
"408",97326,19,20,1,945
"409",97327,22,21,-1,945
"410",97328,22,21,-1,945
"411",97329,21,14,-7,945
"412",97330,22,14,-8,945
"413",97331,23,14,-9,945
"414",97332,24,14,-10,945
"415",97333,24,22,-2,945
"416",97334,25,22,-3,945
"417",97335,26,22,-4,945
"418",97336,25,22,-3,945
"419",97337,23,20,-3,945
"420",97338,23,20,-3,945
"421",97339,23,21,-2,945
"422",97340,23,21,-2,945
"423",97341,24,21,-3,945
"424",97342,24,21,-3,945
"425",97343,23,21,-2,945
"426",97344,23,21,-2,945
"427",97345,23,21,-2,945
"428",97346,23,21,-2,945
"429",97347,56,49,-7,945
"430",97348,118,113,-5,945
"431",97349,113,109,-4,945
"432",98046,14,19,5,945
"433",98047,19,13,-6,945
"434",98048,20,13,-7,945
"435",98049,21,13,-8,945
"436",98050,21,13,-8,945
"437",98051,22,18,-4,945
"438",98052,23,18,-5,945
"439",98053,23,21,-2,945
"440",98054,23,21,-2,945
"441",98055,23,21,-2,945
"442",98056,24,21,-3,945
"443",98057,23,20,-3,945
"444",98058,23,21,-2,945
"445",98059,23,21,-2,945
"446",98060,23,21,-2,945
"447",98061,23,21,-2,945
"448",98062,23,21,-2,945
"449",98063,23,21,-2,945
"450",98064,23,21,-2,945
"451",98065,23,21,-2,945
"452",98066,23,21,-2,945
"453",98067,106,104,-2,945
"454",98068,105,105,0,945
"455",98069,103,102,-1,945
"456",98070,94,93,-1,945
"457",98767,19,12,-7,945
"458",98768,20,13,-7,945
"459",98769,21,17,-4,945
"460",98770,21,17,-4,945
"461",98771,22,20,-2,945
"462",98772,23,20,-3,945
"463",98773,23,21,-2,945
"464",98774,23,21,-2,945
"465",98775,24,21,-3,945
"466",98776,24,21,-3,945
"467",98777,23,21,-2,945
"468",98778,23,21,-2,945
"469",98779,23,21,-2,945
"470",98780,23,21,-2,945
"471",98781,23,21,-2,945
"472",98782,23,21,-2,945
"473",98783,23,21,-2,945
"474",98784,23,21,-2,945
"475",98785,21,20,-1,945
"476",98786,21,20,-1,945
"477",98787,23,19,-4,945
"478",98788,84,80,-4,945
"479",98789,85,79,-6,945
"480",98790,83,77,-6,945
"481",99486,15,12,-3,945
"482",99487,18,12,-6,945
"483",99488,19,12,-7,945
"484",99489,21,17,-4,945
"485",99490,22,17,-5,945
"486",99491,23,20,-3,945
"487",99492,23,20,-3,945
"488",99493,23,21,-2,945
"489",99494,23,21,-2,945
"490",99495,23,21,-2,945
"491",99496,24,22,-2,945
"492",99497,22,21,-1,945
"493",99498,23,21,-2,945
"494",99499,23,21,-2,945
"495",99500,23,21,-2,945
"496",99501,23,21,-2,945
"497",99502,22,21,-1,945
"498",99503,22,21,-1,945
"499",99504,22,21,-1,945
"500",99505,20,20,0,945
"501",99506,21,20,-1,945
"502",99507,22,19,-3,945
"503",99508,55,47,-8,945
"504",99509,101,98,-3,945
"505",99510,101,97,-4,945
"506",100205,14,13,-1,945
"507",100206,15,13,-2,945
"508",100207,16,18,2,945
"509",100208,19,18,-1,945
"510",100209,19,19,0,945
"511",100210,22,20,-2,945
"512",100211,23,21,-2,945
"513",100212,22,21,-1,945
"514",100213,22,21,-1,945
"515",100214,22,21,-1,945
"516",100215,23,22,-1,945
"517",100216,23,22,-1,945
"518",100217,22,21,-1,945
"519",100218,22,21,-1,945
"520",100219,22,21,-1,945
"521",100220,22,21,-1,945
"522",100221,22,21,-1,945
"523",100222,22,21,-1,945
"524",100223,22,21,-1,945
"525",100224,22,21,-1,945
"526",100225,21,18,-3,945
"527",100226,21,19,-2,945
"528",100227,22,19,-3,945
"529",100228,23,19,-4,945
"530",100229,82,81,-1,945
"531",100230,79,78,-1,945
"532",100924,13,12,-1,945
"533",100925,14,13,-1,945
"534",100926,14,13,-1,945
"535",100927,16,18,2,945
"536",100928,16,18,2,945
"537",100929,18,19,1,945
"538",100930,20,19,-1,945
"539",100931,20,20,0,945
"540",100932,21,21,0,945
"541",100933,22,21,-1,945
"542",100934,22,21,-1,945
"543",100935,23,22,-1,945
"544",100936,22,22,0,945
"545",100937,22,21,-1,945
"546",100938,22,21,-1,945
"547",100939,22,21,-1,945
"548",100940,22,21,-1,945
"549",100941,22,21,-1,945
"550",100942,22,21,-1,945
"551",100943,22,21,-1,945
"552",100944,22,21,-1,945
"553",100945,21,18,-3,945
"554",100946,21,18,-3,945
"555",100947,22,19,-3,945
"556",100948,23,19,-4,945
"557",100949,71,66,-5,945
"558",100950,68,64,-4,945
"559",101644,13,17,4,945
"560",101645,13,19,6,945
"561",101646,14,19,5,945
"562",101647,14,20,6,945
"563",101648,17,20,3,945
"564",101649,17,20,3,945
"565",101650,17,20,3,945
"566",101651,19,20,1,945
"567",101652,19,20,1,945
"568",101653,20,21,1,945
"569",101654,20,21,1,945
"570",101655,19,22,3,945
"571",101656,19,22,3,945
"572",101657,20,21,1,945
"573",101658,21,21,0,945
"574",101659,19,19,0,945
"575",101660,21,21,0,945
"576",101661,22,21,-1,945
"577",101662,22,21,-1,945
"578",101663,22,21,-1,945
"579",101664,21,21,0,945
"580",101665,21,19,-2,945
"581",101666,22,20,-2,945
"582",101667,22,20,-2,945
"583",101668,22,20,-2,945
"584",101669,24,23,-1,945
"585",101670,88,85,-3,945
"586",101671,90,87,-3,945
"587",101672,85,83,-2,945
"588",102364,13,17,4,945
"589",102365,13,19,6,945
"590",102366,13,19,6,945
"591",102367,14,20,6,945
"592",102368,16,20,4,945
"593",102369,16,20,4,945
"594",102370,17,20,3,945
"595",102371,17,20,3,945
"596",102372,17,20,3,945
"597",102373,19,20,1,945
"598",102374,19,22,3,945
"599",102375,17,22,5,945
"600",102376,17,22,5,945
"601",102377,17,21,4,945
"602",102378,29,28,-1,945
"603",102379,29,26,-3,945
"604",102380,20,21,1,945
"605",102381,20,21,1,945
"606",102382,20,21,1,945
"607",102383,19,21,2,945
"608",102384,21,21,0,945
"609",102385,21,20,-1,945
"610",102386,21,20,-1,945
"611",102387,22,20,-2,945
"612",102388,22,20,-2,945
"613",102389,21,21,0,945
"614",102390,23,22,-1,945
"615",102391,28,27,-1,945
"616",102392,93,89,-4,945
"617",102393,91,85,-6,945
"618",103084,13,20,7,945
"619",103085,13,20,7,945
"620",103086,13,20,7,945
"621",103087,14,20,6,945
"622",103088,14,20,6,945
"623",103089,16,20,4,945
"624",103090,16,20,4,945
"625",103091,15,19,4,945
"626",103092,16,20,4,945
"627",103093,17,20,3,945
"628",103094,16,21,5,945
"629",103095,16,20,4,945
"630",103096,17,21,4,945
"631",103097,17,21,4,945
"632",103098,17,21,4,945
"633",103099,16,21,5,945
"634",103100,15,21,6,945
"635",103101,15,21,6,945
"636",103102,16,21,5,945
"637",103103,18,21,3,945
"638",103104,18,21,3,945
"639",103105,21,21,0,945
"640",103106,21,21,0,945
"641",103107,21,21,0,945
"642",103108,22,21,-1,945
"643",103109,21,21,0,945
"644",103110,21,21,0,945
"645",103111,21,21,0,945
"646",103112,25,24,-1,945
"647",103113,90,86,-4,945
"648",103114,86,82,-4,945
"649",103115,86,80,-6,945
"650",103116,68,61,-7,945
"651",103804,13,20,7,945
"652",103805,14,20,6,945
"653",103806,14,20,6,945
"654",103807,14,20,6,945
"655",103808,14,20,6,945
"656",103809,15,20,5,945
"657",103810,15,20,5,945
"658",103811,15,20,5,945
"659",103812,15,20,5,945
"660",103813,15,19,4,945
"661",103814,16,20,4,945
"662",103815,16,20,4,945
"663",103816,16,20,4,945
"664",103817,16,21,5,945
"665",103818,16,21,5,945
"666",103819,16,21,5,945
"667",103820,15,21,6,945
"668",103821,14,21,7,945
"669",103822,14,21,7,945
"670",103823,16,21,5,945
"671",103824,17,21,4,945
"672",103825,19,21,2,945
"673",103826,21,21,0,945
"674",103827,21,21,0,945
"675",103828,22,21,-1,945
"676",103829,22,20,-2,945
"677",103830,22,20,-2,945
"678",103831,22,21,-1,945
"679",103832,22,21,-1,945
"680",103833,23,21,-2,945
"681",103834,26,24,-2,945
"682",103835,65,55,-10,945
"683",103836,91,86,-5,945
"684",103837,87,85,-2,945
"685",103838,84,78,-6,945
"686",104524,14,20,6,945
"687",104525,14,20,6,945
"688",104526,14,20,6,945
"689",104527,14,20,6,945
"690",104528,14,20,6,945
"691",104529,15,20,5,945
"692",104530,15,20,5,945
"693",104531,15,20,5,945
"694",104532,15,20,5,945
"695",104533,15,19,4,945
"696",104534,16,19,3,945
"697",104535,16,20,4,945
"698",104536,15,20,5,945
"699",104537,15,20,5,945
"700",104538,15,20,5,945
"701",104539,15,21,6,945
"702",104540,14,21,7,945
"703",104541,14,21,7,945
"704",104542,14,21,7,945
"705",104543,14,21,7,945
"706",104544,15,21,6,945
"707",104545,19,21,2,945
"708",104546,20,21,1,945
"709",104547,21,21,0,945
"710",104548,21,21,0,945
"711",104549,22,20,-2,945
"712",104550,22,20,-2,945
"713",104551,22,21,-1,945
"714",104552,22,21,-1,945
"715",104553,22,21,-1,945
"716",104554,22,21,-1,945
"717",104555,23,21,-2,945
"718",104556,25,22,-3,945
"719",104557,27,25,-2,945
"720",104558,93,88,-5,945
"721",104559,89,87,-2,945
"722",104560,84,82,-2,945
"723",105245,14,20,6,945
"724",105246,14,20,6,945
"725",105247,15,19,4,945
"726",105248,15,19,4,945
"727",105249,15,19,4,945
"728",105250,15,19,4,945
"729",105251,15,19,4,945
"730",105252,15,19,4,945
"731",105253,15,19,4,945
"732",105254,15,19,4,945
"733",105255,15,20,5,945
"734",105256,15,20,5,945
"735",105257,15,20,5,945
"736",105258,15,20,5,945
"737",105259,15,20,5,945
"738",105260,13,20,7,945
"739",105261,13,20,7,945
"740",105262,13,21,8,945
"741",105263,14,21,7,945
"742",105264,14,21,7,945
"743",105265,18,21,3,945
"744",105266,20,21,1,945
"745",105267,21,21,0,945
"746",105268,22,20,-2,945
"747",105269,23,20,-3,945
"748",105270,23,20,-3,945
"749",105271,21,19,-2,945
"750",105272,21,19,-2,945
"751",105273,21,19,-2,945
"752",105274,21,19,-2,945
"753",105275,21,18,-3,945
"754",105276,21,18,-3,945
"755",105277,23,20,-3,945
"756",105278,24,22,-2,945
"757",105279,28,25,-3,945
"758",105280,90,89,-1,945
"759",105281,89,88,-1,945
"760",105282,90,88,-2,945
"761",105283,81,79,-2,945
"762",105965,15,19,4,945
"763",105966,15,19,4,945
"764",105967,15,19,4,945
"765",105968,15,19,4,945
"766",105969,15,19,4,945
"767",105970,15,19,4,945
"768",105971,15,19,4,945
"769",105972,15,19,4,945
"770",105973,15,19,4,945
"771",105974,14,19,5,945
"772",105975,14,20,6,945
"773",105976,14,20,6,945
"774",105977,15,20,5,945
"775",105978,15,20,5,945
"776",105979,14,20,6,945
"777",105980,14,20,6,945
"778",105981,14,20,6,945
"779",105982,14,20,6,945
"780",105983,16,21,5,945
"781",105984,16,21,5,945
"782",105987,21,21,0,945
"783",105988,21,21,0,945
"784",105989,22,20,-2,945
"785",105990,23,19,-4,945
"786",105991,22,18,-4,945
"787",105992,21,18,-3,945
"788",105993,21,18,-3,945
"789",105994,21,18,-3,945
"790",105995,21,12,-9,945
"791",105996,21,11,-10,945
"792",105997,21,18,-3,945
"793",105998,21,19,-2,945
"794",105999,23,21,-2,945
"795",106000,24,22,-2,945
"796",106001,26,24,-2,945
"797",106002,32,29,-3,945
"798",106003,92,89,-3,945
"799",106004,90,87,-3,945
"800",106005,86,82,-4,945
"801",106010,84,83,-1,945
"802",106011,84,82,-2,945
"803",106012,85,82,-3,945
"804",106686,15,19,4,945
"805",106687,15,19,4,945
"806",106688,15,19,4,945
"807",106689,15,19,4,945
"808",106690,15,19,4,945
"809",106691,15,19,4,945
"810",106692,15,19,4,945
"811",106693,14,19,5,945
"812",106694,14,19,5,945
"813",106695,14,20,6,945
"814",106696,15,20,5,945
"815",106697,14,20,6,945
"816",106698,13,20,7,945
"817",106699,13,20,7,945
"818",106700,13,20,7,945
"819",106701,14,20,6,945
"820",106702,14,20,6,945
"821",106703,14,20,6,945
"822",106709,21,20,-1,945
"823",106710,21,19,-2,945
"824",106711,21,17,-4,945
"825",106712,21,18,-3,945
"826",106713,21,18,-3,945
"827",106714,21,15,-6,945
"828",106715,21,11,-10,945
"829",106716,21,11,-10,945
"830",106717,21,18,-3,945
"831",106718,21,19,-2,945
"832",106719,23,21,-2,945
"833",106720,23,21,-2,945
"834",106721,23,21,-2,945
"835",106722,23,21,-2,945
"836",106723,26,25,-1,945
"837",106724,28,27,-1,945
"838",106725,94,90,-4,945
"839",106726,94,89,-5,945
"840",106727,92,87,-5,945
"841",106728,90,87,-3,945
"842",106729,93,90,-3,945
"843",106730,93,91,-2,945
"844",106731,78,74,-4,945
"845",106732,87,85,-2,945
"846",106733,89,86,-3,945
"847",106734,85,82,-3,945
"848",107407,15,19,4,945
"849",107408,15,19,4,945
"850",107409,15,19,4,945
"851",107410,16,19,3,945
"852",107411,16,19,3,945
"853",107412,15,19,4,945
"854",107413,15,19,4,945
"855",107414,15,20,5,945
"856",107415,15,21,6,945
"857",107417,14,21,7,945
"858",107418,14,21,7,945
"859",107419,13,21,8,945
"860",107420,13,21,8,945
"861",107430,22,19,-3,945
"862",107431,20,18,-2,945
"863",107432,20,17,-3,945
"864",107433,21,13,-8,945
"865",107434,21,13,-8,945
"866",107435,21,13,-8,945
"867",107436,21,16,-5,945
"868",107437,21,19,-2,945
"869",107438,21,20,-1,945
"870",107439,23,22,-1,945
"871",107440,23,22,-1,945
"872",107441,23,22,-1,945
"873",107442,23,22,-1,945
"874",107443,22,22,0,945
"875",107444,22,22,0,945
"876",107445,22,22,0,945
"877",107446,22,22,0,945
"878",107447,23,23,0,945
"879",107448,23,23,0,945
"880",107449,24,24,0,945
"881",107450,24,24,0,945
"882",107451,51,48,-3,945
"883",107452,52,48,-4,945
"884",107453,84,81,-3,945
"885",107454,93,91,-2,945
"886",107455,87,86,-1,945
"887",108152,20,15,-5,945
"888",108153,20,13,-7,945
"889",108154,20,13,-7,945
"890",108155,20,13,-7,945
"891",108156,21,13,-8,945
"892",108157,21,19,-2,945
"893",108158,21,20,-1,945
"894",108159,23,22,-1,945
"895",108160,23,22,-1,945
"896",108161,23,22,-1,945
"897",108162,23,22,-1,945
"898",108163,23,22,-1,945
"899",108164,23,22,-1,945
"900",108165,22,22,0,945
"901",108166,22,22,0,945
"902",108167,22,22,0,945
"903",108168,22,22,0,945
"904",108169,22,22,0,945
"905",108170,22,22,0,945
"906",108171,22,22,0,945
"907",108172,59,54,-5,945
"908",108173,62,58,-4,945
"909",108174,86,84,-2,945
"910",108175,94,93,-1,945
"911",108176,87,86,-1,945
"912",108875,19,13,-6,945
"913",108876,19,13,-6,945
"914",108877,19,14,-5,945
"915",108878,20,20,0,945
"916",108879,23,22,-1,945
"917",108880,23,22,-1,945
"918",108881,23,22,-1,945
"919",108882,23,22,-1,945
"920",108883,23,22,-1,945
"921",108884,22,22,0,945
"922",108885,22,22,0,945
"923",108886,22,22,0,945
"924",108887,22,22,0,945
"925",108888,22,22,0,945
"926",108889,22,22,0,945
"927",108890,21,21,0,945
"928",108891,21,21,0,945
"929",108892,22,21,-1,945
"930",108893,23,22,-1,945
"931",108894,35,35,0,945
"932",108895,85,81,-4,945
"933",108896,97,96,-1,945
"934",109597,18,13,-5,945
"935",109598,19,17,-2,945
"936",109599,20,21,1,945
"937",109600,22,22,0,945
"938",109601,23,22,-1,945
"939",109602,23,22,-1,945
"940",109603,22,22,0,945
"941",109604,22,22,0,945
"942",109605,22,22,0,945
"943",109606,22,22,0,945
"944",109607,22,22,0,945
"945",109608,22,22,0,945
"946",109609,22,22,0,945
"947",109610,22,22,0,945
"948",109611,22,22,0,945
"949",109612,22,21,-1,945
"950",109613,23,22,-1,945
"951",109614,24,22,-2,945
"952",109615,25,23,-2,945
"953",110319,19,19,0,945
"954",110320,19,21,2,945
"955",110321,20,19,-1,945
"956",110322,20,19,-1,945
"957",110323,20,20,0,945
"958",110324,20,20,0,945
"959",110325,20,20,0,945
"960",110326,20,20,0,945
"961",110327,20,20,0,945
"962",110328,19,19,0,945
"963",110329,19,19,0,945
"964",110330,19,19,0,945
"965",110331,19,19,0,945
"966",110332,19,19,0,945
"967",110333,21,21,0,945
"968",110334,21,21,0,945
"969",111042,19,18,-1,945
"970",111043,19,18,-1,945
"971",111044,19,18,-1,945
"972",111045,19,18,-1,945
"973",111046,19,18,-1,945
"974",111047,18,18,0,945
"975",111048,18,18,0,945
"976",111049,18,19,1,945
"977",111050,19,19,0,945
"978",111051,19,19,0,945
"979",111052,19,19,0,945
"980",111053,21,21,0,945
"981",111765,18,12,-6,945
"982",111766,18,12,-6,945
"983",111767,18,12,-6,945
"984",111768,17,12,-5,945
"985",111769,15,11,-4,945
"986",111770,16,11,-5,945
"987",111771,17,11,-6,945
"988",111772,17,11,-6,945
"989",34583,55,63,8,959
"990",34584,55,63,8,959
"991",34585,48,58,10,959
"992",35300,60,64,4,959
"993",35301,60,66,6,959
"994",35302,59,63,4,959
"995",35303,62,63,1,959
"996",35304,62,65,3,959
"997",35305,60,63,3,959
"998",35306,54,61,7,959
"999",35307,48,52,4,959
"1000",35308,11,11,0,959
"1001",36018,62,65,3,959
"1002",36019,65,66,1,959
"1003",36020,65,67,2,959
"1004",36021,64,67,3,959
"1005",36022,62,66,4,959
"1006",36023,63,66,3,959
"1007",36024,65,68,3,959
"1008",36025,61,65,4,959
"1009",36026,62,66,4,959
"1010",36027,61,65,4,959
"1011",36028,54,60,6,959
"1012",36029,33,36,3,959
"1013",36031,12,12,0,959
"1014",36032,32,39,7,959
"1015",36033,33,37,4,959
"1016",36034,30,31,1,959
"1017",36035,1,1,0,959
"1018",36036,31,29,-2,959
"1019",36037,30,30,0,959
"1020",36038,23,24,1,959
"1021",36039,22,23,1,959
"1022",36736,58,58,0,959
"1023",36737,61,57,-4,959
"1024",36738,64,63,-1,959
"1025",36739,67,64,-3,959
"1026",36740,64,65,1,959
"1027",36741,63,65,2,959
"1028",36742,63,63,0,959
"1029",36743,63,64,1,959
"1030",36744,66,65,-1,959
"1031",36745,67,65,-2,959
"1032",36746,67,67,0,959
"1033",36747,67,67,0,959
"1034",36748,65,63,-2,959
"1035",36749,62,61,-1,959
"1036",36750,58,62,4,959
"1037",36751,46,54,8,959
"1038",36752,44,53,9,959
"1039",36753,44,51,7,959
"1040",36754,45,48,3,959
"1041",36755,35,41,6,959
"1042",36756,37,40,3,959
"1043",36757,39,39,0,959
"1044",36758,35,36,1,959
"1045",36759,22,21,-1,959
"1046",37454,63,63,0,959
"1047",37455,59,60,1,959
"1048",37456,60,61,1,959
"1049",37457,63,61,-2,959
"1050",37458,62,59,-3,959
"1051",37459,69,63,-6,959
"1052",37460,64,62,-2,959
"1053",37461,66,64,-2,959
"1054",37462,64,63,-1,959
"1055",37463,66,64,-2,959
"1056",37464,67,65,-2,959
"1057",37465,66,66,0,959
"1058",37466,66,68,2,959
"1059",37467,65,67,2,959
"1060",37468,65,64,-1,959
"1061",37469,63,62,-1,959
"1062",37470,57,58,1,959
"1063",37471,51,53,2,959
"1064",37472,42,51,9,959
"1065",37473,37,44,7,959
"1066",37474,39,45,6,959
"1067",37475,34,43,9,959
"1068",37476,36,41,5,959
"1069",37477,37,38,1,959
"1070",37478,34,36,2,959
"1071",37479,32,29,-3,959
"1072",38172,64,61,-3,959
"1073",38173,65,63,-2,959
"1074",38174,65,64,-1,959
"1075",38175,63,62,-1,959
"1076",38176,65,63,-2,959
"1077",38177,68,65,-3,959
"1078",38178,67,64,-3,959
"1079",38179,69,63,-6,959
"1080",38180,62,59,-3,959
"1081",38181,56,60,4,959
"1082",38182,64,61,-3,959
"1083",38183,67,63,-4,959
"1084",38184,69,64,-5,959
"1085",38185,64,66,2,959
"1086",38186,65,65,0,959
"1087",38187,63,65,2,959
"1088",38188,63,63,0,959
"1089",38189,63,62,-1,959
"1090",38190,58,58,0,959
"1091",38191,56,58,2,959
"1092",38192,42,50,8,959
"1093",38193,37,45,8,959
"1094",38194,37,42,5,959
"1095",38195,34,41,7,959
"1096",38196,32,30,-2,959
"1097",38197,25,22,-3,959
"1098",38890,68,63,-5,959
"1099",38891,67,64,-3,959
"1100",38892,65,65,0,959
"1101",38893,69,65,-4,959
"1102",38894,69,64,-5,959
"1103",38895,55,64,9,959
"1104",38896,56,65,9,959
"1105",38897,69,67,-2,959
"1106",38898,67,63,-4,959
"1107",38899,67,62,-5,959
"1108",38900,65,62,-3,959
"1109",38901,68,63,-5,959
"1110",38902,67,62,-5,959
"1111",38903,66,63,-3,959
"1112",38904,69,64,-5,959
"1113",38905,63,64,1,959
"1114",38906,65,65,0,959
"1115",38907,65,65,0,959
"1116",38908,63,64,1,959
"1117",38909,63,65,2,959
"1118",38910,65,62,-3,959
"1119",38911,57,57,0,959
"1120",39608,68,63,-5,959
"1121",39609,69,64,-5,959
"1122",39610,68,63,-5,959
"1123",39611,66,65,-1,959
"1124",39612,65,64,-1,959
"1125",39613,68,64,-4,959
"1126",39614,69,65,-4,959
"1127",39615,58,66,8,959
"1128",39616,56,64,8,959
"1129",39617,69,66,-3,959
"1130",39618,68,65,-3,959
"1131",39619,69,65,-4,959
"1132",39620,70,63,-7,959
"1133",39621,70,63,-7,959
"1134",39622,67,62,-5,959
"1135",39623,67,62,-5,959
"1136",39624,69,63,-6,959
"1137",39625,65,66,1,959
"1138",39626,65,65,0,959
"1139",39627,66,66,0,959
"1140",39628,66,65,-1,959
"1141",39629,64,67,3,959
"1142",39630,57,61,4,959
"1143",40326,64,63,-1,959
"1144",40327,66,63,-3,959
"1145",40328,68,64,-4,959
"1146",40329,69,67,-2,959
"1147",40330,69,67,-2,959
"1148",40331,70,66,-4,959
"1149",40332,68,66,-2,959
"1150",40333,67,66,-1,959
"1151",40334,66,66,0,959
"1152",40335,70,64,-6,959
"1153",40336,70,67,-3,959
"1154",40337,68,66,-2,959
"1155",40338,68,67,-1,959
"1156",40339,69,64,-5,959
"1157",40340,70,65,-5,959
"1158",40341,67,64,-3,959
"1159",40342,66,65,-1,959
"1160",40343,67,67,0,959
"1161",40344,67,64,-3,959
"1162",40345,69,66,-3,959
"1163",40346,70,67,-3,959
"1164",40347,70,69,-1,959
"1165",40348,70,71,1,959
"1166",40349,66,70,4,959
"1167",41044,55,55,0,959
"1168",41045,63,59,-4,959
"1169",41046,63,62,-1,959
"1170",41047,63,64,1,959
"1171",41048,67,65,-2,959
"1172",41049,69,67,-2,959
"1173",41050,69,67,-2,959
"1174",41051,69,67,-2,959
"1175",41052,70,67,-3,959
"1176",41053,70,66,-4,959
"1177",41054,71,67,-4,959
"1178",41055,72,65,-7,959
"1179",41056,70,66,-4,959
"1180",41057,72,68,-4,959
"1181",41058,71,66,-5,959
"1182",41059,73,69,-4,959
"1183",41060,71,67,-4,959
"1184",41061,70,65,-5,959
"1185",41062,67,66,-1,959
"1186",41063,67,67,0,959
"1187",41064,67,67,0,959
"1188",41065,67,67,0,959
"1189",41066,64,63,-1,959
"1190",41067,69,70,1,959
"1191",41068,69,70,1,959
"1192",41069,71,69,-2,959
"1193",41070,70,69,-1,959
"1194",41098,51,49,-2,959
"1195",41099,61,54,-7,959
"1196",41100,56,51,-5,959
"1197",41101,48,46,-2,959
"1198",41102,5,6,1,959
"1199",41104,49,55,6,959
"1200",41105,51,55,4,959
"1201",41106,21,24,3,959
"1202",41107,42,47,5,959
"1203",41108,44,45,1,959
"1204",41762,43,48,5,959
"1205",41763,52,53,1,959
"1206",41764,59,61,2,959
"1207",41765,65,62,-3,959
"1208",41766,66,65,-1,959
"1209",41767,65,64,-1,959
"1210",41768,68,69,1,959
"1211",41769,69,69,0,959
"1212",41770,69,68,-1,959
"1213",41771,69,70,1,959
"1214",41772,70,71,1,959
"1215",41773,71,72,1,959
"1216",41774,75,73,-2,959
"1217",41775,75,73,-2,959
"1218",41776,75,72,-3,959
"1219",41777,75,73,-2,959
"1220",41778,74,73,-1,959
"1221",41779,74,74,0,959
"1222",41780,74,71,-3,959
"1223",41781,73,69,-4,959
"1224",41782,69,69,0,959
"1225",41783,68,69,1,959
"1226",41784,67,70,3,959
"1227",41785,69,70,1,959
"1228",41786,71,71,0,959
"1229",41787,72,71,-1,959
"1230",41788,70,72,2,959
"1231",41789,74,75,1,959
"1232",41790,76,73,-3,959
"1233",41791,73,73,0,959
"1234",41816,73,66,-7,959
"1235",41817,85,76,-9,959
"1236",41818,77,70,-7,959
"1237",41819,62,59,-3,959
"1238",41820,44,44,0,959
"1239",41821,45,41,-4,959
"1240",41822,42,43,1,959
"1241",41823,29,34,5,959
"1242",41824,73,71,-2,959
"1243",41825,75,71,-4,959
"1244",41826,79,72,-7,959
"1245",41827,77,73,-4,959
"1246",41828,74,74,0,959
"1247",41829,59,63,4,959
"1248",42481,8,11,3,959
"1249",42482,31,34,3,959
"1250",42483,53,53,0,959
"1251",42484,60,60,0,959
"1252",42485,62,62,0,959
"1253",42486,65,62,-3,959
"1254",42487,63,61,-2,959
"1255",42488,65,64,-1,959
"1256",42489,68,70,2,959
"1257",42490,69,70,1,959
"1258",42491,69,71,2,959
"1259",42492,70,71,1,959
"1260",42493,70,72,2,959
"1261",42494,74,74,0,959
"1262",42495,75,74,-1,959
"1263",42496,75,75,0,959
"1264",42497,75,74,-1,959
"1265",42498,74,71,-3,959
"1266",42499,75,74,-1,959
"1267",42500,74,72,-2,959
"1268",42501,73,73,0,959
"1269",42502,73,72,-1,959
"1270",42503,71,71,0,959
"1271",42504,71,72,1,959
"1272",42505,74,74,0,959
"1273",42506,75,75,0,959
"1274",42507,75,75,0,959
"1275",42508,74,77,3,959
"1276",42509,77,76,-1,959
"1277",42510,78,76,-2,959
"1278",42511,77,76,-1,959
"1279",42512,70,73,3,959
"1280",42516,24,31,7,959
"1281",42535,77,73,-4,959
"1282",42536,85,79,-6,959
"1283",42537,81,79,-2,959
"1284",42538,75,70,-5,959
"1285",42542,0,0,0,959
"1286",42544,75,73,-2,959
"1287",42545,78,75,-3,959
"1288",42546,79,75,-4,959
"1289",42547,78,75,-3,959
"1290",42548,79,74,-5,959
"1291",42549,75,70,-5,959
"1292",42550,74,65,-9,959
"1293",42551,59,52,-7,959
"1294",42552,60,52,-8,959
"1295",42553,52,50,-2,959
"1296",42554,56,50,-6,959
"1297",42555,58,52,-6,959
"1298",42556,59,52,-7,959
"1299",42557,46,45,-1,959
"1300",42558,45,43,-2,959
"1301",42561,6,9,3,959
"1302",42562,6,9,3,959
"1303",43201,4,5,1,959
"1304",43202,13,13,0,959
"1305",43203,54,54,0,959
"1306",43204,60,56,-4,959
"1307",43205,59,57,-2,959
"1308",43206,65,66,1,959
"1309",43207,66,68,2,959
"1310",43208,65,68,3,959
"1311",43209,64,69,5,959
"1312",43210,67,67,0,959
"1313",43211,70,70,0,959
"1314",43212,71,70,-1,959
"1315",43213,71,71,0,959
"1316",43214,72,72,0,959
"1317",43215,73,73,0,959
"1318",43216,74,73,-1,959
"1319",43217,73,72,-1,959
"1320",43218,75,72,-3,959
"1321",43219,77,75,-2,959
"1322",43220,76,76,0,959
"1323",43221,77,74,-3,959
"1324",43222,75,72,-3,959
"1325",43223,75,71,-4,959
"1326",43224,74,72,-2,959
"1327",43225,74,72,-2,959
"1328",43226,81,76,-5,959
"1329",43227,80,80,0,959
"1330",43228,81,79,-2,959
"1331",43229,80,76,-4,959
"1332",43230,77,78,1,959
"1333",43231,76,74,-2,959
"1334",43232,75,75,0,959
"1335",43233,77,76,-1,959
"1336",43234,79,76,-3,959
"1337",43235,79,78,-1,959
"1338",43236,82,81,-1,959
"1339",43237,77,80,3,959
"1340",43253,77,74,-3,959
"1341",43254,88,82,-6,959
"1342",43255,92,85,-7,959
"1343",43256,83,74,-9,959
"1344",43257,85,78,-7,959
"1345",43258,86,77,-9,959
"1346",43259,68,66,-2,959
"1347",43260,84,80,-4,959
"1348",43261,90,83,-7,959
"1349",43262,86,81,-5,959
"1350",43263,83,80,-3,959
"1351",43264,83,78,-5,959
"1352",43265,82,76,-6,959
"1353",43266,81,77,-4,959
"1354",43267,78,72,-6,959
"1355",43268,72,68,-4,959
"1356",43269,72,67,-5,959
"1357",43270,73,67,-6,959
"1358",43271,80,76,-4,959
"1359",43272,80,70,-10,959
"1360",43273,75,69,-6,959
"1361",43274,69,64,-5,959
"1362",43275,67,61,-6,959
"1363",43276,72,67,-5,959
"1364",43277,83,72,-11,959
"1365",43278,85,76,-9,959
"1366",43279,84,75,-9,959
"1367",43280,85,78,-7,959
"1368",43281,81,75,-6,959
"1369",43282,69,68,-1,959
"1370",43922,6,6,0,959
"1371",43923,18,15,-3,959
"1372",43924,58,57,-1,959
"1373",43925,65,66,1,959
"1374",43926,66,67,1,959
"1375",43927,66,66,0,959
"1376",43928,68,69,1,959
"1377",43929,68,70,2,959
"1378",43930,70,72,2,959
"1379",43931,69,70,1,959
"1380",43932,73,71,-2,959
"1381",43933,74,73,-1,959
"1382",43934,74,73,-1,959
"1383",43935,75,75,0,959
"1384",43936,74,74,0,959
"1385",43937,74,73,-1,959
"1386",43938,77,74,-3,959
"1387",43939,76,73,-3,959
"1388",43940,77,75,-2,959
"1389",43941,77,75,-2,959
"1390",43942,76,75,-1,959
"1391",43943,77,73,-4,959
"1392",43944,76,76,0,959
"1393",43945,76,75,-1,959
"1394",43946,77,74,-3,959
"1395",43947,80,78,-2,959
"1396",43948,77,77,0,959
"1397",43949,78,75,-3,959
"1398",43950,75,74,-1,959
"1399",43951,72,74,2,959
"1400",43952,74,75,1,959
"1401",43953,76,74,-2,959
"1402",43954,75,74,-1,959
"1403",43955,80,77,-3,959
"1404",43956,81,82,1,959
"1405",43957,77,79,2,959
"1406",43959,13,17,4,959
"1407",43960,16,21,5,959
"1408",43964,5,5,0,959
"1409",43972,77,74,-3,959
"1410",43973,88,82,-6,959
"1411",43974,90,82,-8,959
"1412",43975,85,78,-7,959
"1413",43976,88,80,-8,959
"1414",43977,88,83,-5,959
"1415",43978,86,82,-4,959
"1416",43979,87,83,-4,959
"1417",43980,87,85,-2,959
"1418",43981,80,75,-5,959
"1419",43982,76,73,-3,959
"1420",43983,75,73,-2,959
"1421",43984,75,74,-1,959
"1422",43985,77,72,-5,959
"1423",43986,73,68,-5,959
"1424",43987,72,70,-2,959
"1425",43988,72,69,-3,959
"1426",43989,58,50,-8,959
"1427",43990,43,37,-6,959
"1428",43991,15,16,1,959
"1429",43992,11,11,0,959
"1430",43993,11,11,0,959
"1431",43994,11,11,0,959
"1432",43995,11,11,0,959
"1433",43996,44,38,-6,959
"1434",43997,66,60,-6,959
"1435",43998,68,63,-5,959
"1436",43999,73,66,-7,959
"1437",44000,76,71,-5,959
"1438",44001,85,79,-6,959
"1439",44002,83,81,-2,959
"1440",44003,80,77,-3,959
"1441",44004,78,75,-3,959
"1442",44007,17,19,2,959
"1443",44008,17,19,2,959
"1444",44009,9,9,0,959
"1445",44010,9,9,0,959
"1446",44643,8,6,-2,959
"1447",44644,25,20,-5,959
"1448",44645,30,28,-2,959
"1449",44646,30,28,-2,959
"1450",44647,67,63,-4,959
"1451",44648,68,67,-1,959
"1452",44649,71,72,1,959
"1453",44650,73,71,-2,959
"1454",44651,73,71,-2,959
"1455",44652,70,69,-1,959
"1456",44653,73,75,2,959
"1457",44654,73,72,-1,959
"1458",44655,75,74,-1,959
"1459",44656,76,75,-1,959
"1460",44657,75,74,-1,959
"1461",44658,77,75,-2,959
"1462",44659,75,75,0,959
"1463",44660,77,72,-5,959
"1464",44661,77,73,-4,959
"1465",44662,76,74,-2,959
"1466",44663,77,74,-3,959
"1467",44664,78,76,-2,959
"1468",44665,80,75,-5,959
"1469",44666,78,75,-3,959
"1470",44667,78,76,-2,959
"1471",44668,77,75,-2,959
"1472",44669,76,75,-1,959
"1473",44670,76,75,-1,959
"1474",44671,75,74,-1,959
"1475",44672,76,75,-1,959
"1476",44673,79,77,-2,959
"1477",44674,80,77,-3,959
"1478",44675,79,78,-1,959
"1479",44676,87,85,-2,959
"1480",44677,89,87,-2,959
"1481",44678,85,85,0,959
"1482",44679,88,86,-2,959
"1483",44680,88,85,-3,959
"1484",44681,90,89,-1,959
"1485",44682,87,86,-1,959
"1486",44683,88,85,-3,959
"1487",44684,85,83,-2,959
"1488",44685,84,85,1,959
"1489",44686,82,82,0,959
"1490",44687,39,39,0,959
"1491",44693,91,85,-6,959
"1492",44694,96,88,-8,959
"1493",44695,96,85,-11,959
"1494",44696,94,85,-9,959
"1495",44697,95,85,-10,959
"1496",44698,77,73,-4,959
"1497",44699,82,77,-5,959
"1498",44700,83,78,-5,959
"1499",44701,77,75,-2,959
"1500",44702,77,74,-3,959
"1501",44703,77,72,-5,959
"1502",44704,68,62,-6,959
"1503",44705,26,24,-2,959
"1504",44706,11,11,0,959
"1505",44707,8,8,0,959
"1506",44708,8,9,1,959
"1507",44709,8,9,1,959
"1508",44710,9,10,1,959
"1509",44711,9,10,1,959
"1510",44712,9,9,0,959
"1511",44713,9,9,0,959
"1512",44714,10,9,-1,959
"1513",44715,10,10,0,959
"1514",44716,10,11,1,959
"1515",44717,13,14,1,959
"1516",44718,24,26,2,959
"1517",44719,52,49,-3,959
"1518",44720,73,68,-5,959
"1519",44721,75,71,-4,959
"1520",44722,76,72,-4,959
"1521",44723,78,73,-5,959
"1522",44724,86,76,-10,959
"1523",44725,88,78,-10,959
"1524",44726,81,77,-4,959
"1525",44727,90,82,-8,959
"1526",44728,93,89,-4,959
"1527",44729,92,86,-6,959
"1528",44730,95,90,-5,959
"1529",44731,92,87,-5,959
"1530",45364,8,6,-2,959
"1531",45365,8,6,-2,959
"1532",45366,8,6,-2,959
"1533",45367,10,8,-2,959
"1534",45368,12,10,-2,959
"1535",45369,64,63,-1,959
"1536",45370,65,64,-1,959
"1537",45371,34,32,-2,959
"1538",45372,74,72,-2,959
"1539",45373,76,77,1,959
"1540",45374,76,77,1,959
"1541",45375,74,76,2,959
"1542",45376,73,75,2,959
"1543",45377,75,74,-1,959
"1544",45378,80,76,-4,959
"1545",45379,78,78,0,959
"1546",45380,80,80,0,959
"1547",45381,80,79,-1,959
"1548",45382,74,74,0,959
"1549",45383,76,74,-2,959
"1550",45384,77,77,0,959
"1551",45385,77,76,-1,959
"1552",45386,78,75,-3,959
"1553",45387,77,80,3,959
"1554",45388,82,84,2,959
"1555",45389,82,79,-3,959
"1556",45390,82,81,-1,959
"1557",45391,82,82,0,959
"1558",45392,80,80,0,959
"1559",45393,84,84,0,959
"1560",45394,86,84,-2,959
"1561",45395,85,83,-2,959
"1562",45396,86,86,0,959
"1563",45397,89,89,0,959
"1564",45398,88,88,0,959
"1565",45399,91,92,1,959
"1566",45400,88,90,2,959
"1567",45401,90,91,1,959
"1568",45402,91,89,-2,959
"1569",45403,90,90,0,959
"1570",45404,87,89,2,959
"1571",45405,86,86,0,959
"1572",45406,48,51,3,959
"1573",45411,88,82,-6,959
"1574",45412,95,85,-10,959
"1575",45413,96,85,-11,959
"1576",45414,94,88,-6,959
"1577",45415,95,85,-10,959
"1578",45416,93,86,-7,959
"1579",45417,94,87,-7,959
"1580",45418,85,81,-4,959
"1581",45419,81,77,-4,959
"1582",45420,79,74,-5,959
"1583",45421,79,78,-1,959
"1584",45422,78,76,-2,959
"1585",45423,80,75,-5,959
"1586",45424,67,62,-5,959
"1587",45425,11,11,0,959
"1588",45426,8,8,0,959
"1589",45427,7,8,1,959
"1590",45428,7,8,1,959
"1591",45429,9,10,1,959
"1592",45430,9,10,1,959
"1593",45431,10,10,0,959
"1594",45432,9,9,0,959
"1595",45433,9,9,0,959
"1596",45434,10,9,-1,959
"1597",45435,10,10,0,959
"1598",45436,10,11,1,959
"1599",45437,10,11,1,959
"1600",45438,11,11,0,959
"1601",45439,11,12,1,959
"1602",45440,11,12,1,959
"1603",45441,52,50,-2,959
"1604",45442,70,66,-4,959
"1605",45443,80,74,-6,959
"1606",45444,81,77,-4,959
"1607",45445,79,74,-5,959
"1608",45446,91,87,-4,959
"1609",45447,97,91,-6,959
"1610",45448,95,90,-5,959
"1611",45449,97,90,-7,959
"1612",45450,100,93,-7,959
"1613",45451,102,94,-8,959
"1614",45452,102,95,-7,959
"1615",45453,93,90,-3,959
"1616",46085,8,6,-2,959
"1617",46086,8,6,-2,959
"1618",46087,8,7,-1,959
"1619",46088,8,7,-1,959
"1620",46089,8,8,0,959
"1621",46090,8,8,0,959
"1622",46091,12,11,-1,959
"1623",46092,51,48,-3,959
"1624",46093,74,71,-3,959
"1625",46094,75,72,-3,959
"1626",46095,77,74,-3,959
"1627",46096,78,73,-5,959
"1628",46097,81,76,-5,959
"1629",46098,80,76,-4,959
"1630",46099,80,76,-4,959
"1631",46100,81,77,-4,959
"1632",46101,81,78,-3,959
"1633",46102,77,76,-1,959
"1634",46103,78,77,-1,959
"1635",46104,77,77,0,959
"1636",46105,79,79,0,959
"1637",46106,79,78,-1,959
"1638",46107,81,80,-1,959
"1639",46108,82,81,-1,959
"1640",46109,87,82,-5,959
"1641",46110,86,83,-3,959
"1642",46111,85,84,-1,959
"1643",46112,87,86,-1,959
"1644",46113,88,86,-2,959
"1645",46114,90,85,-5,959
"1646",46115,89,87,-2,959
"1647",46116,89,88,-1,959
"1648",46117,91,88,-3,959
"1649",46118,91,90,-1,959
"1650",46119,93,91,-2,959
"1651",46120,92,89,-3,959
"1652",46121,92,89,-3,959
"1653",46122,91,89,-2,959
"1654",46123,92,92,0,959
"1655",46124,90,90,0,959
"1656",46125,84,85,1,959
"1657",46128,14,15,1,959
"1658",46129,93,90,-3,959
"1659",46130,96,91,-5,959
"1660",46131,99,94,-5,959
"1661",46132,97,92,-5,959
"1662",46133,96,90,-6,959
"1663",46134,91,85,-6,959
"1664",46135,92,86,-6,959
"1665",46136,96,87,-9,959
"1666",46137,86,83,-3,959
"1667",46138,84,81,-3,959
"1668",46139,83,78,-5,959
"1669",46140,81,78,-3,959
"1670",46141,61,59,-2,959
"1671",46142,58,57,-1,959
"1672",46143,20,18,-2,959
"1673",46144,11,11,0,959
"1674",46145,8,7,-1,959
"1675",46146,8,7,-1,959
"1676",46147,8,9,1,959
"1677",46148,8,9,1,959
"1678",46149,9,10,1,959
"1679",46150,9,10,1,959
"1680",46151,9,10,1,959
"1681",46152,8,9,1,959
"1682",46153,8,9,1,959
"1683",46154,9,9,0,959
"1684",46155,9,10,1,959
"1685",46156,10,11,1,959
"1686",46157,10,12,2,959
"1687",46158,11,12,1,959
"1688",46159,11,12,1,959
"1689",46160,11,12,1,959
"1690",46161,11,12,1,959
"1691",46162,10,12,2,959
"1692",46163,10,12,2,959
"1693",46164,52,50,-2,959
"1694",46165,71,68,-3,959
"1695",46166,72,70,-2,959
"1696",46167,98,95,-3,959
"1697",46168,99,96,-3,959
"1698",46169,96,91,-5,959
"1699",46170,101,95,-6,959
"1700",46171,100,95,-5,959
"1701",46172,98,92,-6,959
"1702",46173,100,94,-6,959
"1703",46174,96,92,-4,959
"1704",46175,10,10,0,959
"1705",46807,8,7,-1,959
"1706",46808,8,7,-1,959
"1707",46809,8,7,-1,959
"1708",46810,8,7,-1,959
"1709",46811,8,7,-1,959
"1710",46812,14,11,-3,959
"1711",46813,72,71,-1,959
"1712",46814,78,75,-3,959
"1713",46815,76,73,-3,959
"1714",46816,76,73,-3,959
"1715",46817,77,73,-4,959
"1716",46818,81,80,-1,959
"1717",46819,81,80,-1,959
"1718",46820,82,80,-2,959
"1719",46821,82,82,0,959
"1720",46822,81,80,-1,959
"1721",46823,81,79,-2,959
"1722",46824,79,77,-2,959
"1723",46825,81,80,-1,959
"1724",46826,82,81,-1,959
"1725",46827,80,82,2,959
"1726",46828,83,81,-2,959
"1727",46829,88,84,-4,959
"1728",46830,88,85,-3,959
"1729",46831,87,86,-1,959
"1730",46832,89,85,-4,959
"1731",46833,89,85,-4,959
"1732",46834,89,85,-4,959
"1733",46835,87,87,0,959
"1734",46836,89,87,-2,959
"1735",46837,92,88,-4,959
"1736",46838,94,90,-4,959
"1737",46839,91,89,-2,959
"1738",46840,93,89,-4,959
"1739",46841,92,90,-2,959
"1740",46842,92,90,-2,959
"1741",46843,91,93,2,959
"1742",46844,90,92,2,959
"1743",46845,14,17,3,959
"1744",46847,81,83,2,959
"1745",46848,96,91,-5,959
"1746",46849,98,93,-5,959
"1747",46850,79,74,-5,959
"1748",46851,98,94,-4,959
"1749",46852,92,89,-3,959
"1750",46853,91,88,-3,959
"1751",46854,93,89,-4,959
"1752",46855,94,88,-6,959
"1753",46856,94,87,-7,959
"1754",46857,89,84,-5,959
"1755",46858,90,83,-7,959
"1756",46859,82,81,-1,959
"1757",46860,69,69,0,959
"1758",46861,13,11,-2,959
"1759",46862,8,8,0,959
"1760",46863,8,7,-1,959
"1761",46864,8,7,-1,959
"1762",46865,8,7,-1,959
"1763",46866,8,7,-1,959
"1764",46867,8,8,0,959
"1765",46868,8,9,1,959
"1766",46869,7,9,2,959
"1767",46870,8,10,2,959
"1768",46871,8,9,1,959
"1769",46872,8,9,1,959
"1770",46873,8,9,1,959
"1771",46874,8,9,1,959
"1772",46875,9,10,1,959
"1773",46876,9,11,2,959
"1774",46877,9,12,3,959
"1775",46878,11,12,1,959
"1776",46879,11,12,1,959
"1777",46880,11,12,1,959
"1778",46881,11,12,1,959
"1779",46882,10,12,2,959
"1780",46883,10,12,2,959
"1781",46884,10,12,2,959
"1782",46885,11,12,1,959
"1783",46886,11,12,1,959
"1784",46887,20,21,1,959
"1785",46888,88,86,-2,959
"1786",46889,96,94,-2,959
"1787",46890,98,94,-4,959
"1788",46891,106,101,-5,959
"1789",46892,108,101,-7,959
"1790",46893,107,102,-5,959
"1791",46894,107,102,-5,959
"1792",46895,97,94,-3,959
"1793",47527,5,5,0,959
"1794",47528,7,5,-2,959
"1795",47529,7,7,0,959
"1796",47530,8,7,-1,959
"1797",47531,8,6,-2,959
"1798",47532,8,6,-2,959
"1799",47533,22,22,0,959
"1800",47534,55,51,-4,959
"1801",47535,76,69,-7,959
"1802",47536,77,68,-9,959
"1803",47537,78,74,-4,959
"1804",47538,77,73,-4,959
"1805",47539,78,78,0,959
"1806",47540,81,80,-1,959
"1807",47541,88,87,-1,959
"1808",47542,89,87,-2,959
"1809",47543,86,82,-4,959
"1810",47544,84,79,-5,959
"1811",47545,81,79,-2,959
"1812",47546,81,81,0,959
"1813",47547,85,84,-1,959
"1814",47548,85,84,-1,959
"1815",47549,85,86,1,959
"1816",47550,84,86,2,959
"1817",47551,85,86,1,959
"1818",47552,86,87,1,959
"1819",47553,88,86,-2,959
"1820",47554,88,86,-2,959
"1821",47555,90,88,-2,959
"1822",47556,88,90,2,959
"1823",47557,93,94,1,959
"1824",47558,94,94,0,959
"1825",47559,91,91,0,959
"1826",47560,94,95,1,959
"1827",47561,93,93,0,959
"1828",47562,94,92,-2,959
"1829",47563,92,91,-1,959
"1830",47564,61,60,-1,959
"1831",47565,99,96,-3,959
"1832",47566,100,97,-3,959
"1833",47567,95,94,-1,959
"1834",47568,90,87,-3,959
"1835",47569,90,87,-3,959
"1836",47570,96,90,-6,959
"1837",47571,96,92,-4,959
"1838",47572,96,93,-3,959
"1839",47573,94,91,-3,959
"1840",47574,94,90,-4,959
"1841",47575,91,85,-6,959
"1842",47576,94,88,-6,959
"1843",47577,91,87,-4,959
"1844",47578,58,56,-2,959
"1845",47579,14,11,-3,959
"1846",47580,9,8,-1,959
"1847",47581,9,8,-1,959
"1848",47582,8,7,-1,959
"1849",47583,8,7,-1,959
"1850",47584,8,7,-1,959
"1851",47585,8,7,-1,959
"1852",47586,7,7,0,959
"1853",47587,7,8,1,959
"1854",47588,7,8,1,959
"1855",47589,7,8,1,959
"1856",47590,7,8,1,959
"1857",47591,8,8,0,959
"1858",47592,8,8,0,959
"1859",47593,8,8,0,959
"1860",47594,8,8,0,959
"1861",47595,9,8,-1,959
"1862",47596,9,9,0,959
"1863",47597,10,10,0,959
"1864",47598,10,12,2,959
"1865",47599,10,12,2,959
"1866",47600,10,12,2,959
"1867",47601,10,12,2,959
"1868",47602,10,12,2,959
"1869",47603,9,12,3,959
"1870",47604,9,12,3,959
"1871",47605,9,12,3,959
"1872",47606,9,12,3,959
"1873",47607,11,12,1,959
"1874",47608,72,70,-2,959
"1875",47609,106,100,-6,959
"1876",47610,102,97,-5,959
"1877",47611,107,104,-3,959
"1878",47612,109,104,-5,959
"1879",47613,92,88,-4,959
"1880",47614,103,97,-6,959
"1881",47615,106,102,-4,959
"1882",47616,105,102,-3,959
"1883",48248,6,5,-1,959
"1884",48249,6,6,0,959
"1885",48250,6,6,0,959
"1886",48251,7,5,-2,959
"1887",48252,7,5,-2,959
"1888",48253,8,7,-1,959
"1889",48254,8,7,-1,959
"1890",48255,14,12,-2,959
"1891",48256,14,13,-1,959
"1892",48257,30,32,2,959
"1893",48258,73,72,-1,959
"1894",48259,80,77,-3,959
"1895",48260,87,86,-1,959
"1896",48261,89,86,-3,959
"1897",48262,82,80,-2,959
"1898",48263,80,75,-5,959
"1899",48264,76,71,-5,959
"1900",48265,79,79,0,959
"1901",48266,81,81,0,959
"1902",48267,84,86,2,959
"1903",48268,86,87,1,959
"1904",48269,85,88,3,959
"1905",48270,84,87,3,959
"1906",48271,84,88,4,959
"1907",48272,85,87,2,959
"1908",48273,87,88,1,959
"1909",48274,86,88,2,959
"1910",48275,89,88,-1,959
"1911",48276,93,90,-3,959
"1912",48277,95,94,-1,959
"1913",48278,96,96,0,959
"1914",48279,97,97,0,959
"1915",48280,95,96,1,959
"1916",48283,60,61,1,959
"1917",48284,103,97,-6,959
"1918",48285,101,97,-4,959
"1919",48286,100,96,-4,959
"1920",48287,97,96,-1,959
"1921",48288,88,86,-2,959
"1922",48289,93,90,-3,959
"1923",48290,94,92,-2,959
"1924",48291,101,96,-5,959
"1925",48292,101,96,-5,959
"1926",48293,95,89,-6,959
"1927",48294,96,89,-7,959
"1928",48295,87,85,-2,959
"1929",48296,72,70,-2,959
"1930",48297,12,12,0,959
"1931",48298,8,9,1,959
"1932",48299,7,7,0,959
"1933",48300,8,8,0,959
"1934",48301,9,8,-1,959
"1935",48302,8,7,-1,959
"1936",48303,8,7,-1,959
"1937",48304,8,7,-1,959
"1938",48305,7,7,0,959
"1939",48306,7,6,-1,959
"1940",48307,7,8,1,959
"1941",48308,7,8,1,959
"1942",48309,7,8,1,959
"1943",48310,8,8,0,959
"1944",48311,8,8,0,959
"1945",48312,8,8,0,959
"1946",48313,8,8,0,959
"1947",48314,8,8,0,959
"1948",48316,12,12,0,959
"1949",48317,10,9,-1,959
"1950",48318,10,10,0,959
"1951",48319,10,10,0,959
"1952",48320,10,11,1,959
"1953",48321,9,11,2,959
"1954",48322,9,12,3,959
"1955",48323,8,12,4,959
"1956",48324,8,12,4,959
"1957",48325,8,12,4,959
"1958",48326,9,12,3,959
"1959",48327,11,12,1,959
"1960",48328,12,12,0,959
"1961",48329,83,79,-4,959
"1962",48330,99,96,-3,959
"1963",48331,110,107,-3,959
"1964",48332,112,108,-4,959
"1965",48333,110,106,-4,959
"1966",48334,111,106,-5,959
"1967",48335,110,104,-6,959
"1968",48336,106,103,-3,959
"1969",48337,99,98,-1,959
"1970",48338,48,54,6,959
"1971",48948,1,5,4,959
"1972",48949,1,5,4,959
"1973",48950,1,5,4,959
"1974",48951,1,5,4,959
"1975",48952,1,5,4,959
"1976",48968,5,6,1,959
"1977",48969,6,6,0,959
"1978",48970,6,6,0,959
"1979",48971,6,6,0,959
"1980",48972,6,6,0,959
"1981",48973,6,7,1,959
"1982",48974,7,7,0,959
"1983",48975,7,6,-1,959
"1984",48976,7,6,-1,959
"1985",48977,7,6,-1,959
"1986",48978,9,7,-2,959
"1987",48979,9,7,-2,959
"1988",48980,13,13,0,959
"1989",48981,13,13,0,959
"1990",48982,12,12,0,959
"1991",48983,70,68,-2,959
"1992",48984,71,70,-1,959
"1993",48985,81,81,0,959
"1994",48986,80,78,-2,959
"1995",48987,84,84,0,959
"1996",48988,85,85,0,959
"1997",48989,85,85,0,959
"1998",48990,85,85,0,959
"1999",48991,87,86,-1,959
"2000",48992,87,87,0,959
"2001",48993,88,90,2,959
"2002",48994,94,94,0,959
"2003",48995,98,95,-3,959
"2004",48996,99,94,-5,959
"2005",48997,90,92,2,959
"2006",48998,91,91,0,959
"2007",48999,98,94,-4,959
"2008",49000,100,97,-3,959
"2009",49001,104,98,-6,959
"2010",49002,104,98,-6,959
"2011",49003,102,100,-2,959
"2012",49004,103,99,-4,959
"2013",49005,100,95,-5,959
"2014",49006,99,93,-6,959
"2015",49007,97,93,-4,959
"2016",49008,86,86,0,959
"2017",49009,101,95,-6,959
"2018",49010,101,97,-4,959
"2019",49011,89,88,-1,959
"2020",49012,74,72,-2,959
"2021",49013,61,59,-2,959
"2022",49014,49,50,1,959
"2023",49015,8,8,0,959
"2024",49016,8,9,1,959
"2025",49017,7,8,1,959
"2026",49018,7,7,0,959
"2027",49019,7,7,0,959
"2028",49020,8,8,0,959
"2029",49021,8,7,-1,959
"2030",49022,8,7,-1,959
"2031",49023,8,6,-2,959
"2032",49024,7,6,-1,959
"2033",49025,7,6,-1,959
"2034",49026,7,6,-1,959
"2035",49027,7,7,0,959
"2036",49037,12,12,0,959
"2037",49038,9,10,1,959
"2038",49039,9,10,1,959
"2039",49040,10,10,0,959
"2040",49041,10,10,0,959
"2041",49042,10,10,0,959
"2042",49043,8,8,0,959
"2043",49044,8,9,1,959
"2044",49045,8,9,1,959
"2045",49046,8,10,2,959
"2046",49047,9,10,1,959
"2047",49048,9,11,2,959
"2048",49049,15,16,1,959
"2049",49050,81,80,-1,959
"2050",49051,109,107,-2,959
"2051",49052,109,106,-3,959
"2052",49053,107,107,0,959
"2053",49054,105,102,-3,959
"2054",49055,100,99,-1,959
"2055",49056,109,107,-2,959
"2056",49057,109,108,-1,959
"2057",49058,108,107,-1,959
"2058",49059,108,106,-2,959
"2059",49060,58,61,3,959
"2060",49666,1,5,4,959
"2061",49667,1,5,4,959
"2062",49668,1,5,4,959
"2063",49669,1,5,4,959
"2064",49670,1,5,4,959
"2065",49671,1,5,4,959
"2066",49672,1,5,4,959
"2067",49673,2,5,3,959
"2068",49674,2,5,3,959
"2069",49675,2,5,3,959
"2070",49676,2,5,3,959
"2071",49681,2,6,4,959
"2072",49682,2,6,4,959
"2073",49683,2,6,4,959
"2074",49684,2,6,4,959
"2075",49685,2,6,4,959
"2076",49686,2,6,4,959
"2077",49687,2,6,4,959
"2078",49688,4,6,2,959
"2079",49689,6,6,0,959
"2080",49690,6,6,0,959
"2081",49691,6,6,0,959
"2082",49692,6,6,0,959
"2083",49693,6,7,1,959
"2084",49694,7,7,0,959
"2085",49695,7,6,-1,959
"2086",49696,8,6,-2,959
"2087",49697,8,6,-2,959
"2088",49698,7,6,-1,959
"2089",49699,7,6,-1,959
"2090",49700,7,6,-1,959
"2091",49701,7,7,0,959
"2092",49702,7,7,0,959
"2093",49703,12,11,-1,959
"2094",49704,58,58,0,959
"2095",49705,75,76,1,959
"2096",49706,79,77,-2,959
"2097",49707,81,81,0,959
"2098",49708,82,83,1,959
"2099",49709,86,86,0,959
"2100",49710,86,86,0,959
"2101",49711,88,87,-1,959
"2102",49712,98,97,-1,959
"2103",49713,101,97,-4,959
"2104",49714,101,97,-4,959
"2105",49715,95,92,-3,959
"2106",49716,98,95,-3,959
"2107",49717,101,97,-4,959
"2108",49718,102,98,-4,959
"2109",49719,101,100,-1,959
"2110",49720,102,98,-4,959
"2111",49721,105,99,-6,959
"2112",49722,105,99,-6,959
"2113",49723,103,100,-3,959
"2114",49724,93,88,-5,959
"2115",49725,95,88,-7,959
"2116",49726,95,89,-6,959
"2117",49727,89,87,-2,959
"2118",49728,78,78,0,959
"2119",49729,73,70,-3,959
"2120",49730,22,23,1,959
"2121",49731,10,11,1,959
"2122",49732,10,11,1,959
"2123",49733,8,9,1,959
"2124",49734,7,8,1,959
"2125",49735,8,8,0,959
"2126",49736,8,9,1,959
"2127",49737,7,8,1,959
"2128",49738,7,7,0,959
"2129",49739,7,7,0,959
"2130",49740,7,6,-1,959
"2131",49741,8,6,-2,959
"2132",49742,8,6,-2,959
"2133",49743,8,6,-2,959
"2134",49744,7,6,-1,959
"2135",49745,7,6,-1,959
"2136",49746,7,7,0,959
"2137",49758,9,10,1,959
"2138",49759,9,10,1,959
"2139",49760,9,10,1,959
"2140",49761,8,10,2,959
"2141",49762,10,10,0,959
"2142",49763,8,8,0,959
"2143",49764,8,8,0,959
"2144",49765,8,9,1,959
"2145",49766,8,9,1,959
"2146",49767,8,10,2,959
"2147",49768,8,10,2,959
"2148",49769,11,12,1,959
"2149",49770,17,18,1,959
"2150",49771,81,78,-3,959
"2151",49772,102,101,-1,959
"2152",49773,110,111,1,959
"2153",49774,108,107,-1,959
"2154",49775,93,93,0,959
"2155",49776,108,106,-2,959
"2156",49777,108,108,0,959
"2157",49778,109,110,1,959
"2158",49779,106,105,-1,959
"2159",49780,106,106,0,959
"2160",49781,102,102,0,959
"2161",50385,1,5,4,959
"2162",50386,1,5,4,959
"2163",50387,1,5,4,959
"2164",50388,1,5,4,959
"2165",50389,1,5,4,959
"2166",50390,1,5,4,959
"2167",50391,1,5,4,959
"2168",50392,1,5,4,959
"2169",50393,2,6,4,959
"2170",50394,3,6,3,959
"2171",50395,3,6,3,959
"2172",50396,3,6,3,959
"2173",50397,3,6,3,959
"2174",50398,3,6,3,959
"2175",50399,0,5,5,959
"2176",50400,1,6,5,959
"2177",50401,2,6,4,959
"2178",50402,2,6,4,959
"2179",50403,2,6,4,959
"2180",50404,2,6,4,959
"2181",50405,2,6,4,959
"2182",50406,2,6,4,959
"2183",50407,2,4,2,959
"2184",50408,2,4,2,959
"2185",50409,1,1,0,959
"2186",50410,1,1,0,959
"2187",50411,1,1,0,959
"2188",50412,1,1,0,959
"2189",50413,1,2,1,959
"2190",50414,2,2,0,959
"2191",50415,6,3,-3,959
"2192",50416,6,4,-2,959
"2193",50417,7,7,0,959
"2194",50418,7,7,0,959
"2195",50419,8,7,-1,959
"2196",50420,8,7,-1,959
"2197",50421,8,7,-1,959
"2198",50422,11,10,-1,959
"2199",50423,13,11,-2,959
"2200",50424,13,12,-1,959
"2201",50425,38,39,1,959
"2202",50426,73,73,0,959
"2203",50427,82,82,0,959
"2204",50428,86,85,-1,959
"2205",50429,87,86,-1,959
"2206",50430,91,91,0,959
"2207",50431,99,95,-4,959
"2208",50432,99,97,-2,959
"2209",50433,102,99,-3,959
"2210",50434,103,99,-4,959
"2211",50435,103,98,-5,959
"2212",50436,102,98,-4,959
"2213",50437,102,99,-3,959
"2214",50438,102,99,-3,959
"2215",50439,102,100,-2,959
"2216",50440,103,98,-5,959
"2217",50441,107,102,-5,959
"2218",50442,107,102,-5,959
"2219",50443,105,102,-3,959
"2220",50444,93,90,-3,959
"2221",50445,70,67,-3,959
"2222",50446,68,66,-2,959
"2223",50447,16,15,-1,959
"2224",50448,13,13,0,959
"2225",50449,9,8,-1,959
"2226",50450,7,8,1,959
"2227",50451,7,8,1,959
"2228",50452,8,8,0,959
"2229",50453,8,9,1,959
"2230",50454,7,8,1,959
"2231",50455,7,8,1,959
"2232",50456,7,9,2,959
"2233",50457,7,8,1,959
"2234",50458,7,7,0,959
"2235",50459,9,9,0,959
"2236",50460,8,8,0,959
"2237",50461,6,6,0,959
"2238",50462,6,6,0,959
"2239",50463,6,6,0,959
"2240",50464,6,6,0,959
"2241",50479,9,10,1,959
"2242",50480,9,10,1,959
"2243",50481,9,10,1,959
"2244",50482,9,10,1,959
"2245",50483,7,10,3,959
"2246",50484,7,10,3,959
"2247",50485,8,9,1,959
"2248",50486,11,11,0,959
"2249",50487,11,12,1,959
"2250",50488,10,12,2,959
"2251",50489,11,13,2,959
"2252",50490,11,13,2,959
"2253",50491,15,18,3,959
"2254",50492,85,84,-1,959
"2255",50493,115,115,0,959
"2256",50494,115,114,-1,959
"2257",50495,114,114,0,959
"2258",50496,115,114,-1,959
"2259",50497,114,113,-1,959
"2260",50498,114,115,1,959
"2261",50499,112,112,0,959
"2262",50500,112,110,-2,959
"2263",51103,1,5,4,959
"2264",51104,1,5,4,959
"2265",51105,1,5,4,959
"2266",51106,1,5,4,959
"2267",51107,1,5,4,959
"2268",51108,1,5,4,959
"2269",51109,1,5,4,959
"2270",51110,1,5,4,959
"2271",51111,1,5,4,959
"2272",51112,1,5,4,959
"2273",51113,7,11,4,959
"2274",51114,8,11,3,959
"2275",51115,3,6,3,959
"2276",51116,3,6,3,959
"2277",51117,8,11,3,959
"2278",51118,13,16,3,959
"2279",51119,12,17,5,959
"2280",51120,1,6,5,959
"2281",51121,2,6,4,959
"2282",51122,2,6,4,959
"2283",51123,2,6,4,959
"2284",51124,2,6,4,959
"2285",51125,2,6,4,959
"2286",51126,2,6,4,959
"2287",51127,2,4,2,959
"2288",51128,2,4,2,959
"2289",51129,1,1,0,959
"2290",51130,1,2,1,959
"2291",51131,1,2,1,959
"2292",51132,1,2,1,959
"2293",51133,2,2,0,959
"2294",51134,2,3,1,959
"2295",51135,6,4,-2,959
"2296",51136,6,4,-2,959
"2297",51137,7,8,1,959
"2298",51138,7,8,1,959
"2299",51139,8,8,0,959
"2300",51140,8,8,0,959
"2301",51141,8,8,0,959
"2302",51142,8,8,0,959
"2303",51143,15,14,-1,959
"2304",51144,16,15,-1,959
"2305",51145,25,22,-3,959
"2306",51146,36,35,-1,959
"2307",51147,104,101,-3,959
"2308",51148,104,101,-3,959
"2309",51149,105,100,-5,959
"2310",51150,104,99,-5,959
"2311",51151,100,97,-3,959
"2312",51152,97,95,-2,959
"2313",51153,89,89,0,959
"2314",51154,101,100,-1,959
"2315",51155,106,104,-2,959
"2316",51156,106,103,-3,959
"2317",51157,99,95,-4,959
"2318",51158,94,91,-3,959
"2319",51159,91,89,-2,959
"2320",51160,94,92,-2,959
"2321",51161,95,91,-4,959
"2322",51162,84,80,-4,959
"2323",51163,28,29,1,959
"2324",51164,13,12,-1,959
"2325",51165,10,9,-1,959
"2326",51166,9,8,-1,959
"2327",51167,9,8,-1,959
"2328",51168,8,8,0,959
"2329",51169,7,7,0,959
"2330",51170,7,8,1,959
"2331",51171,7,8,1,959
"2332",51172,7,8,1,959
"2333",51173,8,8,0,959
"2334",51174,7,8,1,959
"2335",51175,7,8,1,959
"2336",51176,7,8,1,959
"2337",51177,7,8,1,959
"2338",51178,7,7,0,959
"2339",51179,6,6,0,959
"2340",51180,6,6,0,959
"2341",51181,6,6,0,959
"2342",51182,6,6,0,959
"2343",51201,9,10,1,959
"2344",51202,9,10,1,959
"2345",51203,7,10,3,959
"2346",51204,7,11,4,959
"2347",51205,7,9,2,959
"2348",51206,8,9,1,959
"2349",51207,10,10,0,959
"2350",51208,11,13,2,959
"2351",51209,11,13,2,959
"2352",51210,11,13,2,959
"2353",51211,10,14,4,959
"2354",51212,21,24,3,959
"2355",51213,82,79,-3,959
"2356",51214,115,115,0,959
"2357",51215,114,115,1,959
"2358",51216,114,115,1,959
"2359",51217,114,115,1,959
"2360",51822,1,6,5,959
"2361",51823,2,6,4,959
"2362",51824,2,6,4,959
"2363",51825,2,6,4,959
"2364",51826,2,6,4,959
"2365",51827,2,6,4,959
"2366",51828,1,5,4,959
"2367",51829,1,5,4,959
"2368",51830,1,5,4,959
"2369",51831,1,5,4,959
"2370",51832,1,5,4,959
"2371",51833,1,5,4,959
"2372",51834,1,5,4,959
"2373",51835,2,5,3,959
"2374",51836,2,5,3,959
"2375",51837,2,5,3,959
"2376",51838,3,6,3,959
"2377",51839,3,7,4,959
"2378",51840,1,6,5,959
"2379",51841,2,6,4,959
"2380",51842,2,6,4,959
"2381",51843,2,3,1,959
"2382",51844,2,2,0,959
"2383",51845,1,1,0,959
"2384",51846,2,2,0,959
"2385",51847,2,2,0,959
"2386",51848,2,2,0,959
"2387",51849,6,2,-4,959
"2388",51850,6,2,-4,959
"2389",51851,6,2,-4,959
"2390",51852,6,2,-4,959
"2391",51853,6,2,-4,959
"2392",51854,6,2,-4,959
"2393",51855,2,3,1,959
"2394",51856,2,3,1,959
"2395",51857,3,3,0,959
"2396",51858,3,3,0,959
"2397",51859,3,3,0,959
"2398",51860,3,3,0,959
"2399",51861,9,4,-5,959
"2400",51862,15,9,-6,959
"2401",51863,23,19,-4,959
"2402",51864,99,97,-2,959
"2403",51865,101,98,-3,959
"2404",51866,102,100,-2,959
"2405",51867,97,96,-1,959
"2406",51868,100,99,-1,959
"2407",51869,99,95,-4,959
"2408",51870,97,94,-3,959
"2409",51871,99,97,-2,959
"2410",51872,99,97,-2,959
"2411",51873,93,92,-1,959
"2412",51874,90,90,0,959
"2413",51875,20,17,-3,959
"2414",51876,14,11,-3,959
"2415",51877,12,12,0,959
"2416",51878,12,12,0,959
"2417",51879,9,9,0,959
"2418",51880,10,9,-1,959
"2419",51881,9,9,0,959
"2420",51882,9,9,0,959
"2421",51883,8,8,0,959
"2422",51884,7,7,0,959
"2423",51885,7,7,0,959
"2424",51886,7,7,0,959
"2425",51887,7,7,0,959
"2426",51888,7,7,0,959
"2427",51889,7,7,0,959
"2428",51890,7,8,1,959
"2429",51891,7,8,1,959
"2430",51892,7,8,1,959
"2431",51893,7,8,1,959
"2432",51894,7,8,1,959
"2433",51895,7,8,1,959
"2434",51896,7,8,1,959
"2435",51897,6,7,1,959
"2436",51898,6,7,1,959
"2437",51899,6,6,0,959
"2438",51900,6,6,0,959
"2439",51922,9,9,0,959
"2440",51923,7,10,3,959
"2441",51924,7,10,3,959
"2442",51925,8,10,2,959
"2443",51926,9,10,1,959
"2444",51927,13,14,1,959
"2445",51928,15,16,1,959
"2446",51929,15,17,2,959
"2447",52541,3,6,3,959
"2448",52542,3,6,3,959
"2449",52543,3,6,3,959
"2450",52544,3,6,3,959
"2451",52545,3,6,3,959
"2452",52546,3,6,3,959
"2453",52547,3,6,3,959
"2454",52548,1,5,4,959
"2455",52549,1,5,4,959
"2456",52550,1,5,4,959
"2457",52551,1,5,4,959
"2458",52552,1,5,4,959
"2459",52553,2,5,3,959
"2460",52554,2,5,3,959
"2461",52555,2,6,4,959
"2462",52556,2,6,4,959
"2463",52557,2,5,3,959
"2464",52558,2,5,3,959
"2465",52559,2,7,5,959
"2466",52560,1,7,6,959
"2467",52561,2,6,4,959
"2468",52562,3,7,4,959
"2469",52563,3,3,0,959
"2470",52564,3,3,0,959
"2471",52565,2,2,0,959
"2472",52566,2,2,0,959
"2473",52567,2,2,0,959
"2474",52568,2,2,0,959
"2475",52569,6,2,-4,959
"2476",52570,6,2,-4,959
"2477",52571,6,2,-4,959
"2478",52572,6,2,-4,959
"2479",52573,7,2,-5,959
"2480",52574,7,2,-5,959
"2481",52575,3,2,-1,959
"2482",52576,4,3,-1,959
"2483",52577,9,9,0,959
"2484",52578,19,18,-1,959
"2485",52579,19,18,-1,959
"2486",52580,71,70,-1,959
"2487",52581,72,69,-3,959
"2488",52582,68,66,-2,959
"2489",52583,93,91,-2,959
"2490",52584,97,95,-2,959
"2491",52585,101,98,-3,959
"2492",52586,102,99,-3,959
"2493",52587,103,102,-1,959
"2494",52588,102,101,-1,959
"2495",52589,71,71,0,959
"2496",52590,14,14,0,959
"2497",52591,9,9,0,959
"2498",52592,8,9,1,959
"2499",52593,8,9,1,959
"2500",52594,8,9,1,959
"2501",52595,7,4,-3,959
"2502",52596,7,4,-3,959
"2503",52597,8,8,0,959
"2504",52598,8,8,0,959
"2505",52599,8,9,1,959
"2506",52600,8,9,1,959
"2507",52601,9,9,0,959
"2508",52602,8,8,0,959
"2509",52603,7,7,0,959
"2510",52604,7,7,0,959
"2511",52605,7,7,0,959
"2512",52606,7,7,0,959
"2513",52607,7,7,0,959
"2514",52608,7,7,0,959
"2515",52609,7,7,0,959
"2516",52610,7,7,0,959
"2517",52611,7,8,1,959
"2518",52612,7,8,1,959
"2519",52613,7,8,1,959
"2520",52614,6,7,1,959
"2521",52615,5,6,1,959
"2522",52616,5,6,1,959
"2523",52617,5,6,1,959
"2524",52618,6,7,1,959
"2525",52643,7,10,3,959
"2526",53259,2,5,3,959
"2527",53260,2,5,3,959
"2528",53261,3,6,3,959
"2529",53262,24,26,2,959
"2530",53263,24,26,2,959
"2531",53264,19,24,5,959
"2532",53265,19,23,4,959
"2533",53266,23,26,3,959
"2534",53267,23,26,3,959
"2535",53268,1,5,4,959
"2536",53269,1,5,4,959
"2537",53270,1,5,4,959
"2538",53271,1,5,4,959
"2539",53272,2,5,3,959
"2540",53273,2,5,3,959
"2541",53274,2,5,3,959
"2542",53275,3,6,3,959
"2543",53276,3,6,3,959
"2544",53277,2,6,4,959
"2545",53278,2,5,3,959
"2546",53279,2,6,4,959
"2547",53280,1,6,5,959
"2548",53281,4,9,5,959
"2549",53282,5,10,5,959
"2550",53283,3,2,-1,959
"2551",53284,3,2,-1,959
"2552",53285,2,2,0,959
"2553",53286,2,2,0,959
"2554",53287,2,2,0,959
"2555",53288,2,2,0,959
"2556",53289,5,2,-3,959
"2557",53290,5,2,-3,959
"2558",53291,7,3,-4,959
"2559",53292,13,8,-5,959
"2560",53293,60,60,0,959
"2561",53294,60,60,0,959
"2562",53295,33,33,0,959
"2563",53296,65,64,-1,959
"2564",53297,65,65,0,959
"2565",53298,93,90,-3,959
"2566",53299,94,92,-2,959
"2567",53300,94,91,-3,959
"2568",53301,93,90,-3,959
"2569",53302,94,91,-3,959
"2570",53303,94,93,-1,959
"2571",53304,92,91,-1,959
"2572",53305,27,27,0,959
"2573",53306,25,25,0,959
"2574",53307,10,10,0,959
"2575",53308,8,9,1,959
"2576",53309,8,9,1,959
"2577",53310,8,9,1,959
"2578",53311,8,9,1,959
"2579",53312,8,9,1,959
"2580",53313,8,9,1,959
"2581",53314,8,9,1,959
"2582",53315,8,9,1,959
"2583",53316,8,9,1,959
"2584",53317,8,9,1,959
"2585",53318,8,9,1,959
"2586",53319,7,7,0,959
"2587",53320,6,7,1,959
"2588",53321,7,7,0,959
"2589",53322,7,7,0,959
"2590",53323,7,7,0,959
"2591",53324,7,7,0,959
"2592",53325,7,7,0,959
"2593",53326,7,7,0,959
"2594",53327,7,7,0,959
"2595",53328,6,6,0,959
"2596",53329,6,6,0,959
"2597",53330,6,6,0,959
"2598",53331,6,6,0,959
"2599",53332,5,6,1,959
"2600",53333,5,6,1,959
"2601",53334,5,6,1,959
"2602",53335,5,6,1,959
"2603",53336,5,6,1,959
"2604",53978,2,5,3,959
"2605",53979,2,5,3,959
"2606",53980,2,5,3,959
"2607",53981,3,6,3,959
"2608",53982,12,15,3,959
"2609",53983,12,15,3,959
"2610",53984,5,8,3,959
"2611",53985,24,27,3,959
"2612",53986,24,26,2,959
"2613",53987,23,26,3,959
"2614",53988,22,27,5,959
"2615",53989,21,24,3,959
"2616",53990,16,22,6,959
"2617",53991,13,19,6,959
"2618",53992,3,9,6,959
"2619",53993,1,6,5,959
"2620",53994,1,6,5,959
"2621",53995,1,6,5,959
"2622",53996,2,6,4,959
"2623",53997,2,7,5,959
"2624",53998,3,7,4,959
"2625",53999,3,7,4,959
"2626",54000,4,10,6,959
"2627",54001,2,6,4,959
"2628",54002,3,7,4,959
"2629",54003,3,2,-1,959
"2630",54004,3,2,-1,959
"2631",54005,2,2,0,959
"2632",54006,3,3,0,959
"2633",54007,29,27,-2,959
"2634",54008,29,27,-2,959
"2635",54009,33,28,-5,959
"2636",54010,33,28,-5,959
"2637",54011,88,87,-1,959
"2638",54012,89,88,-1,959
"2639",54013,90,89,-1,959
"2640",54014,91,90,-1,959
"2641",54015,91,90,-1,959
"2642",54016,92,89,-3,959
"2643",54017,80,80,0,959
"2644",54018,80,82,2,959
"2645",54019,78,78,0,959
"2646",54020,69,69,0,959
"2647",54021,66,66,0,959
"2648",54022,37,37,0,959
"2649",54023,10,10,0,959
"2650",54024,8,9,1,959
"2651",54025,8,9,1,959
"2652",54026,8,9,1,959
"2653",54027,8,9,1,959
"2654",54028,8,9,1,959
"2655",54029,8,9,1,959
"2656",54030,8,9,1,959
"2657",54031,8,9,1,959
"2658",54032,8,9,1,959
"2659",54033,8,9,1,959
"2660",54034,8,8,0,959
"2661",54035,7,8,1,959
"2662",54036,7,9,2,959
"2663",54037,7,9,2,959
"2664",54038,7,9,2,959
"2665",54039,6,8,2,959
"2666",54040,6,8,2,959
"2667",54041,7,8,1,959
"2668",54042,7,8,1,959
"2669",54043,7,8,1,959
"2670",54044,7,8,1,959
"2671",54045,6,8,2,959
"2672",54046,6,7,1,959
"2673",54047,6,7,1,959
"2674",54048,6,6,0,959
"2675",54049,5,6,1,959
"2676",54050,5,6,1,959
"2677",54051,5,6,1,959
"2678",54052,5,6,1,959
"2679",54697,2,5,3,959
"2680",54698,2,5,3,959
"2681",54699,2,5,3,959
"2682",54700,2,5,3,959
"2683",54701,2,5,3,959
"2684",54702,2,5,3,959
"2685",54703,2,5,3,959
"2686",54704,2,5,3,959
"2687",54705,4,6,2,959
"2688",54706,6,10,4,959
"2689",54707,24,27,3,959
"2690",54708,23,27,4,959
"2691",54709,18,24,6,959
"2692",54710,15,21,6,959
"2693",54711,19,26,7,959
"2694",54712,20,27,7,959
"2695",54713,20,28,8,959
"2696",54714,21,29,8,959
"2697",54715,21,29,8,959
"2698",54716,21,29,8,959
"2699",54717,21,30,9,959
"2700",54718,23,30,7,959
"2701",54719,25,30,5,959
"2702",54720,4,11,7,959
"2703",54721,1,6,5,959
"2704",54722,28,28,0,959
"2705",54723,29,24,-5,959
"2706",54724,28,24,-4,959
"2707",54725,43,37,-6,959
"2708",54726,46,40,-6,959
"2709",54727,65,57,-8,959
"2710",54728,68,59,-9,959
"2711",54729,74,67,-7,959
"2712",54730,75,69,-6,959
"2713",54731,88,87,-1,959
"2714",54732,89,88,-1,959
"2715",54733,82,80,-2,959
"2716",54734,86,84,-2,959
"2717",54735,86,84,-2,959
"2718",54736,70,69,-1,959
"2719",54737,69,70,1,959
"2720",54738,7,5,-2,959
"2721",54739,3,5,2,959
"2722",54740,3,5,2,959
"2723",54741,4,4,0,959
"2724",54742,4,4,0,959
"2725",54743,9,10,1,959
"2726",54744,9,10,1,959
"2727",54745,9,10,1,959
"2728",54746,9,10,1,959
"2729",54747,8,10,2,959
"2730",54748,8,10,2,959
"2731",54749,8,10,2,959
"2732",54750,8,10,2,959
"2733",54751,7,8,1,959
"2734",54752,7,8,1,959
"2735",54753,7,8,1,959
"2736",54754,7,8,1,959
"2737",54755,7,8,1,959
"2738",54756,6,8,2,959
"2739",54757,6,8,2,959
"2740",54758,6,8,2,959
"2741",54759,6,8,2,959
"2742",54760,6,8,2,959
"2743",54761,6,8,2,959
"2744",54762,7,8,1,959
"2745",54763,7,7,0,959
"2746",54764,7,7,0,959
"2747",54765,7,7,0,959
"2748",54766,7,7,0,959
"2749",54767,6,7,1,959
"2750",54768,6,7,1,959
"2751",55416,3,6,3,959
"2752",55417,3,7,4,959
"2753",55418,3,7,4,959
"2754",55419,3,7,4,959
"2755",55420,3,7,4,959
"2756",55421,2,7,5,959
"2757",55422,2,7,5,959
"2758",55423,2,7,5,959
"2759",55424,2,7,5,959
"2760",55425,3,8,5,959
"2761",55426,3,8,5,959
"2762",55427,3,8,5,959
"2763",55428,3,9,6,959
"2764",55429,3,9,6,959
"2765",55430,7,13,6,959
"2766",55431,19,26,7,959
"2767",55432,21,28,7,959
"2768",55433,21,27,6,959
"2769",55434,21,26,5,959
"2770",55435,21,28,7,959
"2771",55436,21,28,7,959
"2772",55437,21,28,7,959
"2773",55438,24,28,4,959
"2774",55439,24,28,4,959
"2775",55440,3,10,7,959
"2776",55441,6,9,3,959
"2777",55442,27,27,0,959
"2778",55443,30,25,-5,959
"2779",55444,30,25,-5,959
"2780",55445,10,10,0,959
"2781",55446,9,7,-2,959
"2782",55447,13,12,-1,959
"2783",55448,13,11,-2,959
"2784",55449,9,8,-1,959
"2785",55450,8,8,0,959
"2786",55451,3,3,0,959
"2787",55452,3,3,0,959
"2788",55453,7,3,-4,959
"2789",55454,7,3,-4,959
"2790",55455,7,3,-4,959
"2791",55456,7,3,-4,959
"2792",55457,6,4,-2,959
"2793",55458,6,4,-2,959
"2794",55459,3,5,2,959
"2795",55460,3,5,2,959
"2796",55461,4,4,0,959
"2797",55462,4,4,0,959
"2798",55463,8,10,2,959
"2799",55464,8,10,2,959
"2800",55465,8,9,1,959
"2801",55466,8,9,1,959
"2802",55467,8,9,1,959
"2803",55468,8,9,1,959
"2804",55469,8,9,1,959
"2805",55470,8,9,1,959
"2806",55471,6,8,2,959
"2807",55472,6,8,2,959
"2808",55473,6,8,2,959
"2809",55474,6,8,2,959
"2810",55475,6,8,2,959
"2811",55476,6,8,2,959
"2812",55477,6,8,2,959
"2813",55478,6,8,2,959
"2814",55479,6,8,2,959
"2815",55480,6,8,2,959
"2816",55481,6,7,1,959
"2817",55482,6,7,1,959
"2818",55483,6,7,1,959
"2819",55484,6,7,1,959
"2820",56136,2,6,4,959
"2821",56137,3,7,4,959
"2822",56138,3,7,4,959
"2823",56139,3,7,4,959
"2824",56140,3,7,4,959
"2825",56141,2,7,5,959
"2826",56142,2,7,5,959
"2827",56143,2,7,5,959
"2828",56144,2,7,5,959
"2829",56145,3,7,4,959
"2830",56146,3,7,4,959
"2831",56147,2,8,6,959
"2832",56148,2,8,6,959
"2833",56149,2,8,6,959
"2834",56150,2,8,6,959
"2835",56151,2,7,5,959
"2836",56152,2,7,5,959
"2837",56153,2,6,4,959
"2838",56154,2,6,4,959
"2839",56155,2,8,6,959
"2840",56156,2,8,6,959
"2841",56157,12,17,5,959
"2842",56158,22,28,6,959
"2843",56159,23,27,4,959
"2844",56160,3,10,7,959
"2845",56161,1,1,0,959
"2846",56162,3,3,0,959
"2847",56163,6,3,-3,959
"2848",56164,6,3,-3,959
"2849",56165,6,3,-3,959
"2850",56166,6,3,-3,959
"2851",56167,7,3,-4,959
"2852",56168,7,3,-4,959
"2853",56169,7,3,-4,959
"2854",56170,7,3,-4,959
"2855",56171,8,4,-4,959
"2856",56172,8,4,-4,959
"2857",56173,8,4,-4,959
"2858",56174,8,4,-4,959
"2859",56175,8,4,-4,959
"2860",56176,8,4,-4,959
"2861",56177,8,4,-4,959
"2862",56178,8,4,-4,959
"2863",56179,8,5,-3,959
"2864",56180,8,6,-2,959
"2865",56181,8,9,1,959
"2866",56182,7,10,3,959
"2867",56183,8,9,1,959
"2868",56184,8,9,1,959
"2869",56185,6,8,2,959
"2870",56186,6,8,2,959
"2871",56187,6,8,2,959
"2872",56188,6,8,2,959
"2873",56189,6,8,2,959
"2874",56190,6,8,2,959
"2875",56191,6,8,2,959
"2876",56192,6,8,2,959
"2877",56193,6,8,2,959
"2878",56194,6,8,2,959
"2879",56195,6,8,2,959
"2880",56196,6,7,1,959
"2881",56197,6,6,0,959
"2882",56857,2,7,5,959
"2883",56858,3,7,4,959
"2884",56859,3,7,4,959
"2885",56860,3,7,4,959
"2886",56861,2,7,5,959
"2887",56862,2,7,5,959
"2888",56863,2,7,5,959
"2889",56864,2,7,5,959
"2890",56865,1,3,2,959
"2891",56866,2,4,2,959
"2892",56867,2,3,1,959
"2893",56868,2,3,1,959
"2894",56869,2,3,1,959
"2895",56870,2,3,1,959
"2896",56871,2,3,1,959
"2897",56872,2,3,1,959
"2898",56873,2,3,1,959
"2899",56874,2,3,1,959
"2900",56875,2,4,2,959
"2901",56876,2,4,2,959
"2902",56877,2,4,2,959
"2903",56878,2,4,2,959
"2904",56879,3,4,1,959
"2905",56880,1,2,1,959
"2906",56881,1,1,0,959
"2907",56882,3,3,0,959
"2908",56883,6,3,-3,959
"2909",56884,6,3,-3,959
"2910",56885,5,3,-2,959
"2911",56886,6,3,-3,959
"2912",56887,6,3,-3,959
"2913",56888,6,3,-3,959
"2914",56889,6,3,-3,959
"2915",56890,6,3,-3,959
"2916",56891,7,4,-3,959
"2917",56892,7,4,-3,959
"2918",56893,7,4,-3,959
"2919",56894,7,4,-3,959
"2920",56895,7,4,-3,959
"2921",56896,7,4,-3,959
"2922",56897,7,4,-3,959
"2923",56898,7,4,-3,959
"2924",56899,7,4,-3,959
"2925",56900,7,4,-3,959
"2926",56901,7,7,0,959
"2927",56902,7,8,1,959
"2928",56903,7,8,1,959
"2929",56904,7,9,2,959
"2930",56905,6,8,2,959
"2931",56906,6,8,2,959
"2932",56907,6,8,2,959
"2933",56908,6,8,2,959
"2934",56909,6,8,2,959
"2935",56910,6,8,2,959
"2936",56911,6,8,2,959
"2937",56912,6,7,1,959
"2938",57578,2,7,5,959
"2939",57579,3,7,4,959
"2940",57580,3,7,4,959
"2941",57581,2,7,5,959
"2942",57582,2,7,5,959
"2943",57583,2,7,5,959
"2944",57584,2,7,5,959
"2945",57585,1,3,2,959
"2946",57586,1,3,2,959
"2947",57587,1,2,1,959
"2948",57588,1,2,1,959
"2949",57589,1,2,1,959
"2950",57590,1,2,1,959
"2951",57591,1,3,2,959
"2952",57592,2,3,1,959
"2953",57593,2,3,1,959
"2954",57594,2,3,1,959
"2955",57595,2,4,2,959
"2956",57596,2,4,2,959
"2957",57597,2,4,2,959
"2958",57598,2,4,2,959
"2959",57599,2,4,2,959
"2960",57600,1,2,1,959
"2961",57601,4,2,-2,959
"2962",57602,5,4,-1,959
"2963",57603,5,4,-1,959
"2964",57604,5,4,-1,959
"2965",57605,6,3,-3,959
"2966",57606,6,3,-3,959
"2967",57607,6,3,-3,959
"2968",57608,6,3,-3,959
"2969",57609,7,3,-4,959
"2970",57610,7,3,-4,959
"2971",57611,7,3,-4,959
"2972",57612,7,3,-4,959
"2973",57613,7,3,-4,959
"2974",57614,7,3,-4,959
"2975",57615,7,3,-4,959
"2976",57616,7,3,-4,959
"2977",57617,7,3,-4,959
"2978",57618,7,3,-4,959
"2979",57619,6,3,-3,959
"2980",57620,6,3,-3,959
"2981",57621,6,3,-3,959
"2982",57622,6,3,-3,959
"2983",57623,6,7,1,959
"2984",57624,6,7,1,959
"2985",57625,6,6,0,959
"2986",57626,7,6,-1,959
"2987",57627,7,6,-1,959
"2988",57628,7,5,-2,959
"2989",58300,2,7,5,959
"2990",58301,2,3,1,959
"2991",58302,2,3,1,959
"2992",58303,1,3,2,959
"2993",58304,1,3,2,959
"2994",58305,1,2,1,959
"2995",58306,1,2,1,959
"2996",58307,2,2,0,959
"2997",58308,2,2,0,959
"2998",58309,2,2,0,959
"2999",58310,2,2,0,959
"3000",58311,2,2,0,959
"3001",58312,2,2,0,959
"3002",58313,2,2,0,959
"3003",58314,2,2,0,959
"3004",58315,2,2,0,959
"3005",58316,3,2,-1,959
"3006",58317,4,3,-1,959
"3007",58318,4,3,-1,959
"3008",58319,4,4,0,959
"3009",58320,3,2,-1,959
"3010",58321,4,2,-2,959
"3011",58322,5,3,-2,959
"3012",58323,5,3,-2,959
"3013",58324,5,3,-2,959
"3014",58325,6,3,-3,959
"3015",58326,6,3,-3,959
"3016",58327,6,3,-3,959
"3017",58328,6,3,-3,959
"3018",58329,7,3,-4,959
"3019",58330,7,3,-4,959
"3020",58331,7,3,-4,959
"3021",58332,7,3,-4,959
"3022",58333,7,3,-4,959
"3023",58334,7,3,-4,959
"3024",58335,7,3,-4,959
"3025",58336,7,3,-4,959
"3026",58337,7,3,-4,959
"3027",58338,7,3,-4,959
"3028",58339,6,3,-3,959
"3029",58340,6,3,-3,959
"3030",58341,6,3,-3,959
"3031",58342,6,3,-3,959
"3032",58343,6,5,-1,959
"3033",58344,7,5,-2,959
"3034",59022,2,3,1,959
"3035",59023,1,3,2,959
"3036",59024,1,3,2,959
"3037",59025,1,2,1,959
"3038",59026,1,2,1,959
"3039",59027,2,2,0,959
"3040",59028,2,2,0,959
"3041",59029,2,2,0,959
"3042",59030,2,2,0,959
"3043",59031,2,2,0,959
"3044",59032,2,2,0,959
"3045",59033,2,2,0,959
"3046",59034,2,2,0,959
"3047",59035,2,2,0,959
"3048",59036,2,2,0,959
"3049",59037,3,2,-1,959
"3050",59038,3,2,-1,959
"3051",59039,3,3,0,959
"3052",59040,2,2,0,959
"3053",59041,3,2,-1,959
"3054",59042,6,3,-3,959
"3055",59043,5,3,-2,959
"3056",59044,6,3,-3,959
"3057",59045,7,3,-4,959
"3058",59046,7,3,-4,959
"3059",59047,6,3,-3,959
"3060",59048,6,3,-3,959
"3061",59049,6,3,-3,959
"3062",59050,6,3,-3,959
"3063",59051,6,2,-4,959
"3064",59052,6,2,-4,959
"3065",59053,6,2,-4,959
"3066",59054,6,2,-4,959
"3067",59055,6,2,-4,959
"3068",59056,6,2,-4,959
"3069",59057,6,2,-4,959
"3070",59058,6,2,-4,959
"3071",59059,7,2,-5,959
"3072",59750,2,2,0,959
"3073",59751,2,2,0,959
"3074",59752,2,2,0,959
"3075",59753,2,2,0,959
"3076",59754,2,2,0,959
"3077",59755,2,2,0,959
"3078",59756,3,2,-1,959
"3079",59757,3,3,0,959
"3080",59758,3,3,0,959
"3081",59759,3,3,0,959
"3082",59760,2,2,0,959
"3083",59761,3,2,-1,959
"3084",59762,6,3,-3,959
"3085",59763,6,3,-3,959
"3086",59764,6,3,-3,959
"3087",59765,7,3,-4,959
"3088",59766,7,3,-4,959
"3089",59767,7,3,-4,959
"3090",59768,7,3,-4,959
"3091",59769,7,3,-4,959
"3092",59770,7,3,-4,959
"3093",59771,7,2,-5,959
"3094",60474,2,2,0,959
"3095",60475,2,2,0,959
"3096",60476,2,3,1,959
"3097",60477,3,3,0,959
"3098",60478,3,3,0,959
"3099",60479,3,3,0,959
"3100",60480,2,2,0,959
"3101",60481,4,2,-2,959
"3102",60482,6,4,-2,959
"3103",60483,6,4,-2,959
"3104",60484,6,4,-2,959
"3105",60485,6,4,-2,959
"3106",61200,3,2,-1,959
"3107",49060,58,61,3,925
"3108",49061,13,16,3,925
"3109",49780,106,106,0,925
"3110",49781,102,102,0,925
"3111",50494,115,114,-1,925
"3112",50494,115,114,-1,925
"3113",50495,114,114,0,925
"3114",50496,115,114,-1,925
"3115",50497,114,113,-1,925
"3116",50497,114,113,-1,925
"3117",50498,114,115,1,925
"3118",50498,114,115,1,925
"3119",50499,112,112,0,925
"3120",50499,112,112,0,925
"3121",50500,112,110,-2,925
"3122",50501,58,61,3,925
"3123",51209,11,13,2,925
"3124",51210,11,13,2,925
"3125",51211,10,14,4,925
"3126",51212,21,24,3,925
"3127",51213,82,79,-3,925
"3128",51214,115,115,0,925
"3129",51214,115,115,0,925
"3130",51215,114,115,1,925
"3131",51215,114,115,1,925
"3132",51216,114,115,1,925
"3133",51216,114,115,1,925
"3134",51217,114,115,1,925
"3135",51217,114,115,1,925
"3136",51218,114,115,1,925
"3137",51219,112,112,0,925
"3138",51220,111,109,-2,925
"3139",51221,101,101,0,925
"3140",51923,7,10,3,925
"3141",51924,7,10,3,925
"3142",51925,8,10,2,925
"3143",51926,9,10,1,925
"3144",51927,13,14,1,925
"3145",51928,15,16,1,925
"3146",51929,15,17,2,925
"3147",51930,11,13,2,925
"3148",51931,11,13,2,925
"3149",51932,13,15,2,925
"3150",51933,49,51,2,925
"3151",51934,112,111,-1,925
"3152",51935,109,108,-1,925
"3153",51936,108,108,0,925
"3154",51937,109,110,1,925
"3155",51938,109,109,0,925
"3156",51939,112,110,-2,925
"3157",51940,111,111,0,925
"3158",51941,103,103,0,925
"3159",51942,112,111,-1,925
"3160",51943,112,111,-1,925
"3161",51944,35,36,1,925
"3162",52643,7,10,3,925
"3163",52644,8,11,3,925
"3164",52645,8,10,2,925
"3165",52646,9,10,1,925
"3166",52647,10,11,1,925
"3167",52648,14,15,1,925
"3168",52649,15,16,1,925
"3169",52650,15,17,2,925
"3170",52651,13,15,2,925
"3171",52652,14,16,2,925
"3172",52653,14,16,2,925
"3173",52654,75,77,2,925
"3174",52655,114,113,-1,925
"3175",52656,113,112,-1,925
"3176",52657,114,113,-1,925
"3177",52658,108,107,-1,925
"3178",52659,114,113,-1,925
"3179",52660,114,115,1,925
"3180",52661,114,113,-1,925
"3181",52662,114,113,-1,925
"3182",52663,67,68,1,925
"3183",52664,58,59,1,925
"3184",53363,8,10,2,925
"3185",53364,8,10,2,925
"3186",53365,8,9,1,925
"3187",53366,9,9,0,925
"3188",53367,10,10,0,925
"3189",53368,10,11,1,925
"3190",53369,10,12,2,925
"3191",53370,11,12,1,925
"3192",53371,11,13,2,925
"3193",53372,12,14,2,925
"3194",53373,12,14,2,925
"3195",53374,13,15,2,925
"3196",53375,22,23,1,925
"3197",53376,112,112,0,925
"3198",53377,115,115,0,925
"3199",53378,114,113,-1,925
"3200",53379,108,106,-2,925
"3201",53380,100,100,0,925
"3202",53381,116,114,-2,925
"3203",53382,115,114,-1,925
"3204",53383,112,111,-1,925
"3205",53384,112,109,-3,925
"3206",53385,37,38,1,925
"3207",53386,36,36,0,925
"3208",54084,8,10,2,925
"3209",54085,8,9,1,925
"3210",54086,9,9,0,925
"3211",54087,10,10,0,925
"3212",54088,10,11,1,925
"3213",54089,10,12,2,925
"3214",54090,10,12,2,925
"3215",54091,11,12,1,925
"3216",54092,16,17,1,925
"3217",54093,16,18,2,925
"3218",54094,12,14,2,925
"3219",54095,13,15,2,925
"3220",54096,16,18,2,925
"3221",54097,115,114,-1,925
"3222",54098,115,116,1,925
"3223",54099,115,116,1,925
"3224",54100,93,94,1,925
"3225",54101,100,100,0,925
"3226",54102,115,115,0,925
"3227",54103,115,114,-1,925
"3228",54104,113,112,-1,925
"3229",54105,113,112,-1,925
"3230",54106,66,70,4,925
"3231",54805,10,10,0,925
"3232",54806,10,10,0,925
"3233",54807,11,10,-1,925
"3234",54808,11,10,-1,925
"3235",54809,11,10,-1,925
"3236",54810,11,11,0,925
"3237",54811,11,13,2,925
"3238",54812,12,13,1,925
"3239",54813,13,14,1,925
"3240",54814,13,15,2,925
"3241",54815,13,15,2,925
"3242",54816,14,17,3,925
"3243",54817,15,18,3,925
"3244",54818,117,117,0,925
"3245",54819,118,118,0,925
"3246",54820,94,94,0,925
"3247",54821,104,103,-1,925
"3248",54822,111,110,-1,925
"3249",54823,110,110,0,925
"3250",54824,114,113,-1,925
"3251",54825,114,114,0,925
"3252",54826,61,68,7,925
"3253",55526,10,10,0,925
"3254",55527,11,10,-1,925
"3255",55528,11,10,-1,925
"3256",55529,11,10,-1,925
"3257",55530,11,10,-1,925
"3258",55531,11,12,1,925
"3259",55532,11,13,2,925
"3260",55533,12,13,1,925
"3261",55534,13,14,1,925
"3262",55535,13,15,2,925
"3263",55536,13,16,3,925
"3264",55537,14,16,2,925
"3265",55538,14,16,2,925
"3266",55539,15,17,2,925
"3267",55540,41,41,0,925
"3268",55541,93,90,-3,925
"3269",55542,109,107,-2,925
"3270",55543,109,109,0,925
"3271",55544,116,117,1,925
"3272",55545,115,114,-1,925
"3273",55546,102,103,1,925
"3274",55547,54,59,5,925
"3275",56247,11,10,-1,925
"3276",56248,11,10,-1,925
"3277",56249,11,10,-1,925
"3278",56250,11,10,-1,925
"3279",56251,11,10,-1,925
"3280",56252,11,10,-1,925
"3281",56253,11,12,1,925
"3282",56254,12,13,1,925
"3283",56255,13,15,2,925
"3284",56256,13,16,3,925
"3285",56257,14,16,2,925
"3286",56258,18,20,2,925
"3287",56259,18,20,2,925
"3288",56260,19,20,1,925
"3289",56261,67,69,2,925
"3290",56262,93,89,-4,925
"3291",56263,120,119,-1,925
"3292",56264,117,119,2,925
"3293",56265,119,116,-3,925
"3294",56266,120,115,-5,925
"3295",56267,115,112,-3,925
"3296",56268,111,109,-2,925
"3297",56269,64,62,-2,925
"3298",56270,56,60,4,925
"3299",56271,55,59,4,925
"3300",56968,11,10,-1,925
"3301",56969,11,10,-1,925
"3302",56970,11,10,-1,925
"3303",56971,11,10,-1,925
"3304",56972,11,10,-1,925
"3305",56973,11,11,0,925
"3306",56974,11,12,1,925
"3307",56975,12,14,2,925
"3308",56976,13,14,1,925
"3309",56977,14,14,0,925
"3310",56978,14,16,2,925
"3311",56979,16,18,2,925
"3312",56980,16,18,2,925
"3313",56981,15,17,2,925
"3314",56982,16,18,2,925
"3315",56983,29,30,1,925
"3316",56984,122,120,-2,925
"3317",56985,122,119,-3,925
"3318",56986,111,109,-2,925
"3319",56988,40,36,-4,925
"3320",56989,107,109,2,925
"3321",56990,118,116,-2,925
"3322",56991,118,116,-2,925
"3323",56992,21,21,0,925
"3324",56993,19,19,0,925
"3325",57690,11,10,-1,925
"3326",57691,11,10,-1,925
"3327",57692,11,11,0,925
"3328",57693,10,9,-1,925
"3329",57694,13,12,-1,925
"3330",57695,13,14,1,925
"3331",57696,12,13,1,925
"3332",57697,14,13,-1,925
"3333",57698,13,12,-1,925
"3334",57699,14,13,-1,925
"3335",57700,14,14,0,925
"3336",57701,15,17,2,925
"3337",57702,16,18,2,925
"3338",57703,18,20,2,925
"3339",57704,22,24,2,925
"3340",57705,110,109,-1,925
"3341",57706,121,119,-2,925
"3342",57707,115,114,-1,925
"3343",57708,54,55,1,925
"3344",57710,118,118,0,925
"3345",57711,121,124,3,925
"3346",57712,121,124,3,925
"3347",57713,110,110,0,925
"3348",57714,58,58,0,925
"3349",58411,11,11,0,925
"3350",58412,11,11,0,925
"3351",58413,10,9,-1,925
"3352",58414,10,9,-1,925
"3353",58415,10,10,0,925
"3354",58416,11,11,0,925
"3355",58417,12,12,0,925
"3356",58418,14,13,-1,925
"3357",58419,14,13,-1,925
"3358",58420,14,13,-1,925
"3359",58421,14,15,1,925
"3360",58422,14,15,1,925
"3361",58423,14,16,2,925
"3362",58424,14,16,2,925
"3363",58425,18,18,0,925
"3364",58426,93,95,2,925
"3365",58427,120,119,-1,925
"3366",58428,116,117,1,925
"3367",58429,114,114,0,925
"3368",58430,63,61,-2,925
"3369",58431,118,117,-1,925
"3370",58432,121,124,3,925
"3371",58433,123,125,2,925
"3372",58434,121,122,1,925
"3373",58435,95,94,-1,925
"3374",59133,13,12,-1,925
"3375",59134,13,12,-1,925
"3376",59135,10,12,2,925
"3377",59136,10,11,1,925
"3378",59137,11,11,0,925
"3379",59138,13,12,-1,925
"3380",59139,15,14,-1,925
"3381",59140,15,14,-1,925
"3382",59141,15,14,-1,925
"3383",59142,14,13,-1,925
"3384",59143,15,14,-1,925
"3385",59144,15,15,0,925
"3386",59145,15,16,1,925
"3387",59146,19,20,1,925
"3388",59147,66,68,2,925
"3389",59148,111,115,4,925
"3390",59149,123,122,-1,925
"3391",59150,124,122,-2,925
"3392",59151,125,125,0,925
"3393",59151,125,125,0,925
"3394",59152,118,119,1,925
"3395",59153,111,110,-1,925
"3396",59154,123,124,1,925
"3397",59855,12,14,2,925
"3398",59856,10,12,2,925
"3399",59857,10,11,1,925
"3400",59858,13,11,-2,925
"3401",59859,13,12,-1,925
"3402",59860,14,13,-1,925
"3403",59861,15,14,-1,925
"3404",59862,15,14,-1,925
"3405",59863,16,15,-1,925
"3406",59864,15,14,-1,925
"3407",59865,15,15,0,925
"3408",59866,15,15,0,925
"3409",59867,18,17,-1,925
"3410",59868,73,71,-2,925
"3411",59868,73,71,-2,925
"3412",59869,103,101,-2,925
"3413",59869,103,101,-2,925
"3414",59870,112,111,-1,925
"3415",59870,112,111,-1,925
"3416",59871,130,128,-2,925
"3417",59871,130,128,-2,925
"3418",59872,128,129,1,925
"3419",59873,123,125,2,925
"3420",59874,123,123,0,925
"3421",60577,8,9,1,925
"3422",60578,10,10,0,925
"3423",60579,13,11,-2,925
"3424",60580,13,11,-2,925
"3425",60581,14,11,-3,925
"3426",60582,13,10,-3,925
"3427",60583,13,10,-3,925
"3428",60584,15,10,-5,925
"3429",60585,15,11,-4,925
"3430",60586,15,11,-4,925
"3431",60586,15,11,-4,925
"3432",60587,15,11,-4,925
"3433",60587,15,11,-4,925
"3434",60588,20,17,-3,925
"3435",60588,20,17,-3,925
"3436",60589,70,72,2,925
"3437",60590,101,101,0,925
"3438",61298,9,9,0,925
"3439",61299,11,10,-1,925
"3440",61300,11,10,-1,925
"3441",61301,13,10,-3,925
"3442",61302,13,10,-3,925
"3443",61303,13,10,-3,925
"3444",61304,13,10,-3,925
"3445",61304,13,10,-3,925
"3446",61305,14,11,-3,925
"3447",61305,14,11,-3,925
"3448",61306,15,11,-4,925
"3449",61306,15,11,-4,925
"3450",61307,15,11,-4,925
"3451",61308,17,14,-3,925
"3452",62020,12,12,0,925
"3453",62021,12,12,0,925
"3454",62022,13,12,-1,925
"3455",62022,13,12,-1,925
"3456",62023,14,12,-2,925
"3457",62023,14,12,-2,925
"3458",62024,14,12,-2,925
"3459",62024,14,12,-2,925
"3460",62025,14,12,-2,925
"3461",59151,125,125,0,848
"3462",59154,123,124,1,848
"3463",59155,122,123,1,848
"3464",59156,106,105,-1,848
"3465",59868,73,71,-2,848
"3466",59869,103,101,-2,848
"3467",59870,112,111,-1,848
"3468",59871,130,128,-2,848
"3469",59872,128,129,1,848
"3470",59873,123,125,2,848
"3471",59874,123,123,0,848
"3472",59875,123,121,-2,848
"3473",59876,120,118,-2,848
"3474",60586,15,11,-4,848
"3475",60587,15,11,-4,848
"3476",60588,20,17,-3,848
"3477",60589,70,72,2,848
"3478",60590,101,101,0,848
"3479",60591,131,132,1,848
"3480",60592,120,120,0,848
"3481",60595,121,120,-1,848
"3482",60596,121,119,-2,848
"3483",61304,13,10,-3,848
"3484",61305,14,11,-3,848
"3485",61306,15,11,-4,848
"3486",61307,15,11,-4,848
"3487",61308,17,14,-3,848
"3488",61309,20,19,-1,848
"3489",61310,43,41,-2,848
"3490",61311,132,132,0,848
"3491",61312,129,127,-2,848
"3492",61314,0,0,0,848
"3493",61316,0,0,0,848
"3494",62022,13,12,-1,848
"3495",62023,14,12,-2,848
"3496",62024,14,12,-2,848
"3497",62025,14,12,-2,848
"3498",62026,15,12,-3,848
"3499",62027,15,11,-4,848
"3500",62028,15,11,-4,848
"3501",62029,15,11,-4,848
"3502",62030,32,28,-4,848
"3503",62031,121,121,0,848
"3504",62032,133,133,0,848
"3505",62033,126,125,-1,848
"3506",62742,13,12,-1,848
"3507",62743,13,12,-1,848
"3508",62744,13,12,-1,848
"3509",62745,14,12,-2,848
"3510",62746,14,12,-2,848
"3511",62747,14,11,-3,848
"3512",62748,15,11,-4,848
"3513",62749,15,11,-4,848
"3514",62750,21,17,-4,848
"3515",62751,106,102,-4,848
"3516",62752,135,135,0,848
"3517",62753,129,130,1,848
"3518",63463,11,11,0,848
"3519",63464,11,11,0,848
"3520",63465,12,11,-1,848
"3521",63466,13,11,-2,848
"3522",63467,15,12,-3,848
"3523",63468,16,12,-4,848
"3524",63469,17,13,-4,848
"3525",63470,29,25,-4,848
"3526",63471,108,105,-3,848
"3527",63472,133,129,-4,848
"3528",63473,125,121,-4,848
"3529",64183,11,11,0,848
"3530",64184,11,11,0,848
"3531",64185,12,11,-1,848
"3532",64186,12,11,-1,848
"3533",64187,13,12,-1,848
"3534",64188,16,12,-4,848
"3535",64189,16,12,-4,848
"3536",64190,21,17,-4,848
"3537",64191,72,68,-4,848
"3538",64192,129,125,-4,848
"3539",64193,121,119,-2,848
"3540",64903,9,9,0,848
"3541",64904,10,9,-1,848
"3542",64905,10,9,-1,848
"3543",64906,10,9,-1,848
"3544",64907,12,11,-1,848
"3545",64908,13,11,-2,848
"3546",64909,16,12,-4,848
"3547",64910,41,37,-4,848
"3548",64911,106,106,0,848
"3549",64912,106,104,-2,848
"3550",65623,11,10,-1,848
"3551",65624,11,9,-2,848
"3552",65625,11,9,-2,848
"3553",65626,12,9,-3,848
"3554",65627,13,11,-2,848
"3555",65628,15,11,-4,848
"3556",65629,17,12,-5,848
"3557",65630,32,28,-4,848
"3558",65631,113,108,-5,848
"3559",65632,108,104,-4,848
"3560",66342,14,11,-3,848
"3561",66343,14,11,-3,848
"3562",66344,15,11,-4,848
"3563",66345,14,11,-3,848
"3564",66346,14,11,-3,848
"3565",66347,14,10,-4,848
"3566",66348,15,10,-5,848
"3567",66349,17,13,-4,848
"3568",66350,23,20,-3,848
"3569",66351,100,95,-5,848
"3570",66352,98,93,-5,848
"3571",67062,13,11,-2,848
"3572",67063,14,11,-3,848
"3573",67064,15,11,-4,848
"3574",67065,15,12,-3,848
"3575",67066,16,12,-4,848
"3576",67067,15,11,-4,848
"3577",67068,15,10,-5,848
"3578",67069,17,13,-4,848
"3579",67070,23,19,-4,848
"3580",67071,108,101,-7,848
"3581",67072,103,98,-5,848
"3582",67782,13,11,-2,848
"3583",67783,14,11,-3,848
"3584",67784,15,12,-3,848
"3585",67785,16,13,-3,848
"3586",67786,16,12,-4,848
"3587",67787,16,12,-4,848
"3588",67788,17,12,-5,848
"3589",67789,16,12,-4,848
"3590",67790,21,17,-4,848
"3591",67791,123,116,-7,848
"3592",67792,118,113,-5,848
"3593",68502,13,11,-2,848
"3594",68503,13,11,-2,848
"3595",68504,14,11,-3,848
"3596",68505,16,11,-5,848
"3597",68506,16,11,-5,848
"3598",68507,16,12,-4,848
"3599",68508,17,12,-5,848
"3600",68509,16,12,-4,848
"3601",68510,21,17,-4,848
"3602",68511,111,101,-10,848
"3603",68512,109,98,-11,848
"3604",69222,13,10,-3,848
"3605",69223,13,10,-3,848
"3606",69224,14,10,-4,848
"3607",69225,15,11,-4,848
"3608",69226,17,12,-5,848
"3609",69227,17,13,-4,848
"3610",69228,17,12,-5,848
"3611",69229,18,11,-7,848
"3612",69230,23,16,-7,848
"3613",69231,83,73,-10,848
"3614",69232,82,72,-10,848
"3615",69943,13,10,-3,848
"3616",69944,14,10,-4,848
"3617",69945,16,12,-4,848
"3618",69946,17,12,-5,848
"3619",69947,16,12,-4,848
"3620",69948,16,12,-4,848
"3621",69949,17,11,-6,848
"3622",69950,18,11,-7,848
"3623",69951,118,111,-7,848
"3624",69952,116,110,-6,848
"3625",70663,13,10,-3,848
"3626",70664,14,10,-4,848
"3627",70665,15,10,-5,848
"3628",70666,15,10,-5,848
"3629",70667,15,10,-5,848
"3630",70668,15,11,-4,848
"3631",70669,17,12,-5,848
"3632",70670,20,15,-5,848
"3633",70671,110,103,-7,848
"3634",70672,110,103,-7,848
"3635",71383,13,10,-3,848
"3636",71384,14,10,-4,848
"3637",71385,16,11,-5,848
"3638",71386,16,11,-5,848
"3639",71387,16,11,-5,848
"3640",71388,16,12,-4,848
"3641",71389,18,14,-4,848
"3642",71390,21,16,-5,848
"3643",71391,106,99,-7,848
"3644",71392,105,99,-6,848
"3645",72103,14,10,-4,848
"3646",72104,15,10,-5,848
"3647",72105,15,10,-5,848
"3648",72106,15,10,-5,848
"3649",72107,15,10,-5,848
"3650",72108,15,10,-5,848
"3651",72109,16,10,-6,848
"3652",72110,21,14,-7,848
"3653",72111,31,28,-3,848
"3654",72112,117,108,-9,848
"3655",72113,113,103,-10,848
"3656",72823,14,10,-4,848
"3657",72824,15,10,-5,848
"3658",72825,15,10,-5,848
"3659",72826,15,10,-5,848
"3660",72827,15,10,-5,848
"3661",72828,16,10,-6,848
"3662",72829,16,10,-6,848
"3663",72830,17,10,-7,848
"3664",72831,19,13,-6,848
"3665",72832,47,37,-10,848
"3666",72833,45,36,-9,848
"3667",73544,14,9,-5,848
"3668",73545,15,10,-5,848
"3669",73546,15,10,-5,848
"3670",73547,16,10,-6,848
"3671",73548,16,10,-6,848
"3672",73549,16,11,-5,848
"3673",73550,17,11,-6,848
"3674",73551,17,11,-6,848
"3675",73552,38,31,-7,848
"3676",73553,134,117,-17,848
"3677",73554,128,113,-15,848
"3678",74264,13,10,-3,848
"3679",74265,15,10,-5,848
"3680",74266,15,10,-5,848
"3681",74267,16,10,-6,848
"3682",74268,16,10,-6,848
"3683",74269,16,11,-5,848
"3684",74270,17,11,-6,848
"3685",74271,18,12,-6,848
"3686",74272,18,12,-6,848
"3687",74273,94,85,-9,848
"3688",74274,136,128,-8,848
"3689",74275,122,112,-10,848
"3690",74276,117,106,-11,848
"3691",74985,15,10,-5,848
"3692",74986,16,10,-6,848
"3693",74987,16,10,-6,848
"3694",74988,16,11,-5,848
"3695",74989,16,11,-5,848
"3696",74990,18,12,-6,848
"3697",74991,18,12,-6,848
"3698",74992,18,12,-6,848
"3699",74993,19,12,-7,848
"3700",74994,134,122,-12,848
"3701",74995,146,134,-12,848
"3702",74996,140,129,-11,848
"3703",75705,14,9,-5,848
"3704",75706,15,9,-6,848
"3705",75707,16,9,-7,848
"3706",75708,16,11,-5,848
"3707",75709,17,12,-5,848
"3708",75710,18,12,-6,848
"3709",75711,18,12,-6,848
"3710",75712,18,12,-6,848
"3711",75713,19,10,-9,848
"3712",75714,32,20,-12,848
"3713",75715,137,123,-14,848
"3714",75716,133,119,-14,848
"3715",76426,14,10,-4,848
"3716",76427,14,10,-4,848
"3717",76428,15,10,-5,848
"3718",76429,15,11,-4,848
"3719",76430,16,11,-5,848
"3720",76431,16,10,-6,848
"3721",76432,16,10,-6,848
"3722",76433,19,9,-10,848
"3723",76434,21,10,-11,848
"3724",76435,48,35,-13,848
"3725",76436,142,130,-12,848
"3726",76437,135,122,-13,848
"3727",77147,14,9,-5,848
"3728",77148,14,9,-5,848
"3729",77149,15,10,-5,848
"3730",77150,15,10,-5,848
"3731",77151,16,10,-6,848
"3732",77152,16,10,-6,848
"3733",77153,20,9,-11,848
"3734",77154,20,9,-11,848
"3735",77155,22,11,-11,848
"3736",77156,91,73,-18,848
"3737",77157,90,74,-16,848
"3738",77867,13,10,-3,848
"3739",77868,14,10,-4,848
"3740",77869,16,9,-7,848
"3741",77870,17,9,-8,848
"3742",77871,18,10,-8,848
"3743",77872,20,10,-10,848
"3744",77873,21,10,-11,848
"3745",77874,21,10,-11,848
"3746",77875,21,12,-9,848
"3747",77876,28,18,-10,848
"3748",77877,66,55,-11,848
"3749",77878,63,54,-9,848
"3750",78588,14,10,-4,848
"3751",78589,17,9,-8,848
"3752",78590,17,9,-8,848
"3753",78591,18,10,-8,848
"3754",78592,20,10,-10,848
"3755",78593,20,10,-10,848
"3756",78594,21,10,-11,848
"3757",78595,20,11,-9,848
"3758",78596,21,12,-9,848
"3759",78597,94,78,-16,848
"3760",78598,123,106,-17,848
"3761",78599,121,102,-19,848
"3762",79309,18,10,-8,848
"3763",79310,19,11,-8,848
"3764",79311,20,11,-9,848
"3765",79312,19,11,-8,848
"3766",79313,20,12,-8,848
"3767",79314,20,12,-8,848
"3768",79315,20,13,-7,848
"3769",79316,20,13,-7,848
"3770",79317,67,51,-16,848
"3771",79318,100,84,-16,848
"3772",79319,96,78,-18,848
"3773",80030,18,11,-7,848
"3774",80031,19,11,-8,848
"3775",80032,19,11,-8,848
"3776",80033,21,12,-9,848
"3777",80034,21,12,-9,848
"3778",80035,21,13,-8,848
"3779",80036,21,13,-8,848
"3780",80037,20,13,-7,848
"3781",80038,41,30,-11,848
"3782",80039,128,110,-18,848
"3783",80040,177,153,-24,848
"3784",80041,172,155,-17,848
"3785",80042,162,150,-12,848
"3786",80043,153,138,-15,848
"3787",80751,20,13,-7,848
"3788",80752,20,13,-7,848
"3789",80753,20,13,-7,848
"3790",80754,21,13,-8,848
"3791",80755,21,13,-8,848
"3792",80756,21,13,-8,848
"3793",80757,19,13,-6,848
"3794",80758,22,15,-7,848
"3795",80759,37,30,-7,848
"3796",80760,166,151,-15,848
"3797",80761,178,160,-18,848
"3798",80762,168,147,-21,848
"3799",80763,178,160,-18,848
"3800",80764,172,163,-9,848
"3801",80765,165,151,-14,848
"3802",81472,21,13,-8,848
"3803",81473,21,13,-8,848
"3804",81474,22,14,-8,848
"3805",81475,22,14,-8,848
"3806",81476,22,14,-8,848
"3807",81477,20,14,-6,848
"3808",81478,22,15,-7,848
"3809",81479,27,19,-8,848
"3810",81480,46,39,-7,848
"3811",81481,178,163,-15,848
"3812",81482,178,163,-15,848
"3813",81483,176,163,-13,848
"3814",81484,175,164,-11,848
"3815",81485,173,164,-9,848
"3816",81486,154,145,-9,848
"3817",82192,19,14,-5,848
"3818",82193,19,14,-5,848
"3819",82194,19,14,-5,848
"3820",82195,20,14,-6,848
"3821",82196,20,14,-6,848
"3822",82197,20,14,-6,848
"3823",82198,22,15,-7,848
"3824",82199,23,14,-9,848
"3825",82200,40,30,-10,848
"3826",82201,92,68,-24,848
"3827",82202,155,138,-17,848
"3828",82203,178,165,-13,848
"3829",82204,175,165,-10,848
"3830",82205,93,81,-12,848
"3831",82206,90,80,-10,848
"3832",82913,19,14,-5,848
"3833",82914,19,14,-5,848
"3834",82915,19,14,-5,848
"3835",82916,19,14,-5,848
"3836",82917,19,14,-5,848
"3837",82918,20,14,-6,848
"3838",82919,20,13,-7,848
"3839",82920,28,19,-9,848
"3840",82921,63,46,-17,848
"3841",82922,93,71,-22,848
"3842",82923,92,73,-19,848
"3843",82924,67,54,-13,848
"3844",82925,41,37,-4,848
"3845",83633,17,13,-4,848
"3846",83634,17,13,-4,848
"3847",83635,17,13,-4,848
"3848",83636,17,13,-4,848
"3849",83637,17,13,-4,848
"3850",83638,18,13,-5,848
"3851",83639,19,13,-6,848
"3852",83640,19,13,-6,848
"3853",83641,19,14,-5,848
"3854",83642,24,20,-4,848
"3855",83643,25,20,-5,848
"3856",83644,24,20,-4,848
"3857",84354,17,13,-4,848
"3858",84355,17,13,-4,848
"3859",84356,18,13,-5,848
"3860",84357,18,13,-5,848
"3861",84358,18,13,-5,848
"3862",84359,17,13,-4,848
"3863",84360,19,14,-5,848
"3864",84361,15,13,-2,848
"3865",84362,28,22,-6,848
"3866",84363,29,21,-8,848
"3867",84364,29,21,-8,848
"3868",85076,15,15,0,848
"3869",85077,15,14,-1,848
"3870",85078,16,14,-2,848
"3871",85079,13,13,0,848
"3872",85080,13,13,0,848
"3873",85081,16,13,-3,848
"3874",85082,18,14,-4,848
