"","INDEX","X2000","X2087","change","EEZID"
"1",82205,90,89,-1,945
"2",82206,88,89,1,945
"3",82924,65,53,-12,945
"4",82925,39,43,4,945
"5",82926,160,155,-5,945
"6",82927,150,149,-1,945
"7",83644,24,27,3,945
"8",83645,27,29,2,945
"9",83646,39,44,5,945
"10",83647,37,42,5,945
"11",83651,136,127,-9,945
"12",83652,135,127,-8,945
"13",83653,135,124,-11,945
"14",84362,24,28,4,945
"15",84363,27,33,6,945
"16",84364,28,33,5,945
"17",84365,21,26,5,945
"18",84366,23,28,5,945
"19",84367,150,150,0,945
"20",84368,148,150,2,945
"21",84371,155,145,-10,945
"22",84372,157,146,-11,945
"23",84373,157,145,-12,945
"24",84374,157,145,-12,945
"25",85077,15,13,-2,945
"26",85078,16,13,-3,945
"27",85079,13,15,2,945
"28",85080,13,15,2,945
"29",85081,16,17,1,945
"30",85082,17,19,2,945
"31",85083,18,24,6,945
"32",85084,19,24,5,945
"33",85085,28,24,-4,945
"34",85086,28,25,-3,945
"35",85087,33,29,-4,945
"36",85088,80,80,0,945
"37",85091,142,131,-11,945
"38",85092,153,140,-13,945
"39",85093,133,117,-16,945
"40",85094,155,139,-16,945
"41",85095,111,94,-17,945
"42",85796,15,13,-2,945
"43",85797,15,13,-2,945
"44",85798,15,13,-2,945
"45",85799,13,16,3,945
"46",85800,14,17,3,945
"47",85801,16,19,3,945
"48",85802,15,19,4,945
"49",85803,15,21,6,945
"50",85804,17,22,5,945
"51",85805,27,23,-4,945
"52",85806,27,24,-3,945
"53",85807,29,25,-4,945
"54",85808,164,164,0,945
"55",85809,162,163,1,945
"56",85811,153,147,-6,945
"57",85812,167,157,-10,945
"58",85813,118,105,-13,945
"59",85814,149,130,-19,945
"60",85815,141,125,-16,945
"61",86516,15,16,1,945
"62",86517,14,17,3,945
"63",86518,14,17,3,945
"64",86519,15,18,3,945
"65",86520,15,19,4,945
"66",86521,16,20,4,945
"67",86522,16,20,4,945
"68",86523,16,22,6,945
"69",86524,17,21,4,945
"70",86525,26,23,-3,945
"71",86526,33,31,-2,945
"72",86527,42,42,0,945
"73",86528,52,51,-1,945
"74",86529,161,154,-7,945
"75",86530,146,140,-6,945
"76",86532,154,146,-8,945
"77",86533,159,146,-13,945
"78",86534,159,144,-15,945
"79",86535,158,144,-14,945
"80",86536,126,117,-9,945
"81",87236,13,16,3,945
"82",87237,14,17,3,945
"83",87238,14,17,3,945
"84",87239,14,18,4,945
"85",87240,14,18,4,945
"86",87241,15,19,4,945
"87",87242,15,19,4,945
"88",87243,18,22,4,945
"89",87244,21,21,0,945
"90",87245,26,22,-4,945
"91",87246,28,28,0,945
"92",87247,38,38,0,945
"93",87248,40,41,1,945
"94",87249,121,115,-6,945
"95",87250,163,158,-5,945
"96",87251,159,154,-5,945
"97",87253,154,144,-10,945
"98",87254,158,144,-14,945
"99",87255,121,109,-12,945
"100",87256,110,100,-10,945
"101",87956,13,20,7,945
"102",87957,14,20,6,945
"103",87958,15,20,5,945
"104",87959,14,20,6,945
"105",87960,14,21,7,945
"106",87961,15,21,6,945
"107",87962,16,21,5,945
"108",87963,22,21,-1,945
"109",87964,23,20,-3,945
"110",87965,25,21,-4,945
"111",87966,25,22,-3,945
"112",87967,27,22,-5,945
"113",87968,33,31,-2,945
"114",87969,84,72,-12,945
"115",87970,123,103,-20,945
"116",87971,149,137,-12,945
"117",87972,146,134,-12,945
"118",87974,151,142,-9,945
"119",87975,157,146,-11,945
"120",87976,153,144,-9,945
"121",87977,136,128,-8,945
"122",88676,13,21,8,945
"123",88677,13,21,8,945
"124",88678,15,21,6,945
"125",88679,15,21,6,945
"126",88680,15,21,6,945
"127",88681,15,21,6,945
"128",88682,16,21,5,945
"129",88683,22,21,-1,945
"130",88684,24,21,-3,945
"131",88685,24,21,-3,945
"132",88686,25,22,-3,945
"133",88687,27,22,-5,945
"134",88688,27,22,-5,945
"135",88689,162,131,-31,945
"136",88690,162,131,-31,945
"137",88691,156,142,-14,945
"138",88692,152,139,-13,945
"139",88695,141,132,-9,945
"140",88696,142,133,-9,945
"141",88697,152,143,-9,945
"142",88698,149,141,-8,945
"143",89397,18,21,3,945
"144",89398,18,21,3,945
"145",89399,18,21,3,945
"146",89400,21,21,0,945
"147",89401,21,21,0,945
"148",89402,21,21,0,945
"149",89403,22,21,-1,945
"150",89404,24,21,-3,945
"151",89405,24,21,-3,945
"152",89406,24,22,-2,945
"153",89407,24,22,-2,945
"154",89408,25,22,-3,945
"155",89409,79,78,-1,945
"156",89410,157,147,-10,945
"157",89411,151,142,-9,945
"158",89412,136,126,-10,945
"159",89413,79,78,-1,945
"160",89415,147,143,-4,945
"161",89416,149,145,-4,945
"162",89417,60,51,-9,945
"163",89418,151,146,-5,945
"164",89419,149,143,-6,945
"165",90117,18,21,3,945
"166",90118,18,21,3,945
"167",90119,21,21,0,945
"168",90120,21,21,0,945
"169",90121,21,21,0,945
"170",90122,21,21,0,945
"171",90123,22,21,-1,945
"172",90124,24,21,-3,945
"173",90125,24,21,-3,945
"174",90126,23,22,-1,945
"175",90127,24,22,-2,945
"176",90128,24,22,-2,945
"177",90129,27,23,-4,945
"178",90130,34,30,-4,945
"179",90131,151,141,-10,945
"180",90132,150,142,-8,945
"181",90136,147,145,-2,945
"182",90137,148,145,-3,945
"183",90138,30,21,-9,945
"184",90139,151,146,-5,945
"185",90140,147,143,-4,945
"186",90141,106,107,1,945
"187",90838,19,21,2,945
"188",90839,21,21,0,945
"189",90840,21,21,0,945
"190",90841,22,21,-1,945
"191",90842,22,21,-1,945
"192",90843,20,21,1,945
"193",90844,21,21,0,945
"194",90845,24,21,-3,945
"195",90846,25,21,-4,945
"196",90847,25,21,-4,945
"197",90848,25,22,-3,945
"198",90849,24,21,-3,945
"199",90850,25,22,-3,945
"200",90851,26,18,-8,945
"201",90852,118,110,-8,945
"202",90853,130,124,-6,945
"203",90854,127,121,-6,945
"204",90855,102,100,-2,945
"205",90857,147,144,-3,945
"206",90858,149,145,-4,945
"207",90859,31,22,-9,945
"208",90860,136,138,2,945
"209",90861,136,140,4,945
"210",90862,120,126,6,945
"211",91559,19,21,2,945
"212",91560,20,21,1,945
"213",91561,20,21,1,945
"214",91562,21,21,0,945
"215",91563,20,21,1,945
"216",91564,21,21,0,945
"217",91565,24,21,-3,945
"218",91566,24,21,-3,945
"219",91567,25,21,-4,945
"220",91568,25,21,-4,945
"221",91569,24,21,-3,945
"222",91570,26,22,-4,945
"223",91571,26,18,-8,945
"224",91572,26,18,-8,945
"225",91573,119,114,-5,945
"226",91574,119,114,-5,945
"227",91575,124,117,-7,945
"228",91576,112,107,-5,945
"229",91578,103,99,-4,945
"230",91579,104,101,-3,945
"231",91580,36,29,-7,945
"232",91581,136,140,4,945
"233",91582,130,136,6,945
"234",92280,20,21,1,945
"235",92281,21,21,0,945
"236",92282,22,21,-1,945
"237",92283,22,21,-1,945
"238",92284,22,21,-1,945
"239",92285,23,21,-2,945
"240",92286,25,21,-4,945
"241",92287,25,21,-4,945
"242",92288,25,21,-4,945
"243",92289,23,20,-3,945
"244",92290,24,20,-4,945
"245",92291,20,17,-3,945
"246",92292,21,17,-4,945
"247",92293,36,29,-7,945
"248",92294,79,72,-7,945
"249",92295,124,116,-8,945
"250",92296,121,113,-8,945
"251",92298,129,127,-2,945
"252",92299,136,132,-4,945
"253",92300,35,30,-5,945
"254",92301,105,105,0,945
"255",92302,129,123,-6,945
"256",92303,80,74,-6,945
"257",93002,24,23,-1,945
"258",93003,22,21,-1,945
"259",93004,22,21,-1,945
"260",93005,22,21,-1,945
"261",93006,24,21,-3,945
"262",93007,25,21,-4,945
"263",93008,26,22,-4,945
"264",93009,24,21,-3,945
"265",93010,24,20,-4,945
"266",93011,20,16,-4,945
"267",93012,20,17,-3,945
"268",93013,27,21,-6,945
"269",93014,72,66,-6,945
"270",93015,113,105,-8,945
"271",93016,110,102,-8,945
"272",93019,81,80,-1,945
"273",93020,82,81,-1,945
"274",93021,22,20,-2,945
"275",93022,131,127,-4,945
"276",93023,129,126,-3,945
"277",93024,123,121,-2,945
"278",93722,22,21,-1,945
"279",93723,22,21,-1,945
"280",93724,22,21,-1,945
"281",93725,22,21,-1,945
"282",93726,23,22,-1,945
"283",93727,23,21,-2,945
"284",93728,23,21,-2,945
"285",93729,24,18,-6,945
"286",93730,23,16,-7,945
"287",93731,24,17,-7,945
"288",93732,25,18,-7,945
"289",93733,25,21,-4,945
"290",93734,28,22,-6,945
"291",93735,84,75,-9,945
"292",93736,125,117,-8,945
"293",93737,121,114,-7,945
"294",93739,124,124,0,945
"295",93740,127,126,-1,945
"296",93741,44,41,-3,945
"297",93742,28,24,-4,945
"298",93743,89,81,-8,945
"299",93744,130,124,-6,945
"300",93745,115,110,-5,945
"301",94442,22,21,-1,945
"302",94443,22,21,-1,945
"303",94444,22,21,-1,945
"304",94445,22,21,-1,945
"305",94446,22,21,-1,945
"306",94447,21,20,-1,945
"307",94448,23,21,-2,945
"308",94449,24,17,-7,945
"309",94450,23,16,-7,945
"310",94451,24,17,-7,945
"311",94452,25,17,-8,945
"312",94453,24,21,-3,945
"313",94454,24,21,-3,945
"314",94455,29,26,-3,945
"315",94456,86,71,-15,945
"316",94457,122,101,-21,945
"317",94458,121,100,-21,945
"318",94459,121,115,-6,945
"319",94460,122,117,-5,945
"320",94461,122,115,-7,945
"321",94462,45,43,-2,945
"322",94463,29,25,-4,945
"323",94464,109,105,-4,945
"324",94465,120,118,-2,945
"325",94466,113,111,-2,945
"326",95162,21,21,0,945
"327",95163,22,21,-1,945
"328",95164,22,21,-1,945
"329",95165,20,20,0,945
"330",95166,20,20,0,945
"331",95167,21,20,-1,945
"332",95168,21,20,-1,945
"333",95169,22,15,-7,945
"334",95170,22,15,-7,945
"335",95171,23,19,-4,945
"336",95172,23,19,-4,945
"337",95173,23,21,-2,945
"338",95174,24,22,-2,945
"339",95175,24,21,-3,945
"340",95176,62,49,-13,945
"341",95177,73,52,-21,945
"342",95178,73,51,-22,945
"343",95179,120,100,-20,945
"344",95180,114,108,-6,945
"345",95181,120,114,-6,945
"346",95182,119,109,-10,945
"347",95183,24,21,-3,945
"348",95184,29,26,-3,945
"349",95185,92,85,-7,945
"350",95186,119,117,-2,945
"351",95187,109,104,-5,945
"352",95882,20,20,0,945
"353",95883,22,21,-1,945
"354",95884,22,20,-2,945
"355",95885,20,20,0,945
"356",95886,20,20,0,945
"357",95887,21,20,-1,945
"358",95888,21,19,-2,945
"359",95889,21,15,-6,945
"360",95890,22,15,-7,945
"361",95891,23,19,-4,945
"362",95892,23,19,-4,945
"363",95893,23,21,-2,945
"364",95894,24,22,-2,945
"365",95895,24,21,-3,945
"366",95896,25,21,-4,945
"367",95897,37,25,-12,945
"368",95898,40,28,-12,945
"369",95899,69,43,-26,945
"370",95900,118,98,-20,945
"371",95901,115,106,-9,945
"372",95902,115,106,-9,945
"373",95903,24,21,-3,945
"374",95904,24,20,-4,945
"375",95905,23,21,-2,945
"376",95906,66,55,-11,945
"377",95907,116,99,-17,945
"378",95908,110,93,-17,945
"379",96603,19,19,0,945
"380",96604,20,20,0,945
"381",96605,21,16,-5,945
"382",96606,21,16,-5,945
"383",96607,21,13,-8,945
"384",96608,22,14,-8,945
"385",96609,16,18,2,945
"386",96610,16,18,2,945
"387",96611,23,19,-4,945
"388",96612,23,19,-4,945
"389",96613,23,21,-2,945
"390",96614,25,22,-3,945
"391",96615,25,21,-4,945
"392",96616,25,21,-4,945
"393",96617,22,20,-2,945
"394",96618,22,20,-2,945
"395",96619,25,12,-13,945
"396",96620,115,94,-21,945
"397",96621,114,94,-20,945
"398",96622,39,28,-11,945
"399",96623,22,12,-10,945
"400",96624,22,11,-11,945
"401",96625,25,12,-13,945
"402",96626,25,13,-12,945
"403",96627,62,44,-18,945
"404",96628,112,97,-15,945
"405",96629,104,88,-16,945
"406",97324,18,18,0,945
"407",97325,20,15,-5,945
"408",97326,20,15,-5,945
"409",97327,21,13,-8,945
"410",97328,21,13,-8,945
"411",97329,16,17,1,945
"412",97330,16,17,1,945
"413",97331,22,19,-3,945
"414",97332,23,19,-4,945
"415",97333,24,21,-3,945
"416",97334,25,22,-3,945
"417",97335,25,21,-4,945
"418",97336,24,22,-2,945
"419",97337,22,20,-2,945
"420",97338,22,20,-2,945
"421",97339,22,10,-12,945
"422",97340,22,10,-12,945
"423",97341,22,12,-10,945
"424",97342,22,12,-10,945
"425",97343,22,12,-10,945
"426",97344,22,12,-10,945
"427",97345,22,11,-11,945
"428",97346,22,11,-11,945
"429",97347,55,35,-20,945
"430",97348,114,96,-18,945
"431",97349,109,92,-17,945
"432",98046,13,11,-2,945
"433",98047,18,15,-3,945
"434",98048,19,15,-4,945
"435",98049,21,18,-3,945
"436",98050,21,18,-3,945
"437",98051,22,19,-3,945
"438",98052,23,19,-4,945
"439",98053,23,20,-3,945
"440",98054,22,20,-2,945
"441",98055,23,20,-3,945
"442",98056,23,21,-2,945
"443",98057,22,21,-1,945
"444",98058,22,21,-1,945
"445",98059,22,19,-3,945
"446",98060,22,19,-3,945
"447",98061,22,12,-10,945
"448",98062,22,12,-10,945
"449",98063,22,8,-14,945
"450",98064,22,8,-14,945
"451",98065,22,8,-14,945
"452",98066,22,8,-14,945
"453",98067,108,87,-21,945
"454",98068,108,87,-21,945
"455",98069,103,84,-19,945
"456",98070,97,77,-20,945
"457",98767,18,18,0,945
"458",98768,20,19,-1,945
"459",98769,21,19,-2,945
"460",98770,21,19,-2,945
"461",98771,23,19,-4,945
"462",98772,23,19,-4,945
"463",98773,23,20,-3,945
"464",98774,22,21,-1,945
"465",98775,23,20,-3,945
"466",98776,23,20,-3,945
"467",98777,22,20,-2,945
"468",98778,22,20,-2,945
"469",98779,22,19,-3,945
"470",98780,22,19,-3,945
"471",98781,22,12,-10,945
"472",98782,22,12,-10,945
"473",98783,22,9,-13,945
"474",98784,22,8,-14,945
"475",98785,20,8,-12,945
"476",98786,20,8,-12,945
"477",98787,21,8,-13,945
"478",98788,84,59,-25,945
"479",98789,85,59,-26,945
"480",98790,83,58,-25,945
"481",99486,17,15,-2,945
"482",99487,17,18,1,945
"483",99488,18,18,0,945
"484",99489,21,19,-2,945
"485",99490,22,19,-3,945
"486",99491,23,19,-4,945
"487",99492,23,19,-4,945
"488",99493,23,21,-2,945
"489",99494,22,21,-1,945
"490",99495,23,20,-3,945
"491",99496,22,20,-2,945
"492",99497,21,20,-1,945
"493",99498,21,20,-1,945
"494",99499,22,19,-3,945
"495",99500,22,20,-2,945
"496",99501,22,12,-10,945
"497",99502,22,11,-11,945
"498",99503,22,9,-13,945
"499",99504,22,8,-14,945
"500",99505,20,8,-12,945
"501",99506,20,8,-12,945
"502",99507,21,8,-13,945
"503",99508,56,30,-26,945
"504",99509,99,80,-19,945
"505",99510,100,80,-20,945
"506",100205,16,18,2,945
"507",100206,16,18,2,945
"508",100207,16,18,2,945
"509",100208,17,18,1,945
"510",100209,19,18,-1,945
"511",100210,22,19,-3,945
"512",100211,22,20,-2,945
"513",100212,22,21,-1,945
"514",100213,21,21,0,945
"515",100214,21,21,0,945
"516",100215,22,20,-2,945
"517",100216,22,20,-2,945
"518",100217,22,20,-2,945
"519",100218,22,20,-2,945
"520",100219,22,19,-3,945
"521",100220,22,13,-9,945
"522",100221,22,9,-13,945
"523",100222,22,8,-14,945
"524",100223,22,8,-14,945
"525",100224,22,8,-14,945
"526",100225,22,8,-14,945
"527",100226,22,8,-14,945
"528",100227,22,8,-14,945
"529",100228,23,8,-15,945
"530",100229,80,57,-23,945
"531",100230,76,55,-21,945
"532",100924,14,17,3,945
"533",100925,15,18,3,945
"534",100926,16,18,2,945
"535",100927,17,18,1,945
"536",100928,17,18,1,945
"537",100929,18,18,0,945
"538",100930,19,18,-1,945
"539",100931,19,19,0,945
"540",100932,21,21,0,945
"541",100933,22,21,-1,945
"542",100934,21,21,0,945
"543",100935,22,20,-2,945
"544",100936,22,20,-2,945
"545",100937,21,20,-1,945
"546",100938,21,19,-2,945
"547",100939,21,15,-6,945
"548",100940,21,13,-8,945
"549",100941,21,9,-12,945
"550",100942,22,8,-14,945
"551",100943,22,8,-14,945
"552",100944,22,8,-14,945
"553",100945,22,8,-14,945
"554",100946,22,8,-14,945
"555",100947,22,8,-14,945
"556",100948,23,8,-15,945
"557",100949,69,47,-22,945
"558",100950,65,45,-20,945
"559",101644,13,18,5,945
"560",101645,14,18,4,945
"561",101646,14,18,4,945
"562",101647,16,19,3,945
"563",101648,18,19,1,945
"564",101649,18,19,1,945
"565",101650,18,19,1,945
"566",101651,19,19,0,945
"567",101652,21,20,-1,945
"568",101653,22,20,-2,945
"569",101654,22,20,-2,945
"570",101655,21,20,-1,945
"571",101656,20,20,0,945
"572",101657,20,19,-1,945
"573",101658,20,19,-1,945
"574",101659,18,11,-7,945
"575",101660,20,12,-8,945
"576",101661,21,9,-12,945
"577",101662,21,8,-13,945
"578",101663,21,8,-13,945
"579",101664,20,8,-12,945
"580",101665,20,8,-12,945
"581",101666,21,8,-13,945
"582",101667,21,8,-13,945
"583",101668,21,8,-13,945
"584",101669,22,10,-12,945
"585",101670,87,70,-17,945
"586",101671,88,72,-16,945
"587",101672,83,68,-15,945
"588",102364,13,18,5,945
"589",102365,13,18,5,945
"590",102366,14,18,4,945
"591",102367,14,19,5,945
"592",102368,17,19,2,945
"593",102369,17,19,2,945
"594",102370,18,19,1,945
"595",102371,18,19,1,945
"596",102372,19,20,1,945
"597",102373,20,19,-1,945
"598",102374,21,20,-1,945
"599",102375,20,20,0,945
"600",102376,20,20,0,945
"601",102377,20,19,-1,945
"602",102378,30,19,-11,945
"603",102379,28,17,-11,945
"604",102380,20,9,-11,945
"605",102381,21,8,-13,945
"606",102382,21,8,-13,945
"607",102383,20,8,-12,945
"608",102384,20,8,-12,945
"609",102385,20,8,-12,945
"610",102386,20,8,-12,945
"611",102387,21,8,-13,945
"612",102388,21,8,-13,945
"613",102389,20,8,-12,945
"614",102390,21,9,-12,945
"615",102391,27,16,-11,945
"616",102392,88,73,-15,945
"617",102393,89,70,-19,945
"618",103084,12,19,7,945
"619",103085,12,19,7,945
"620",103086,13,19,6,945
"621",103087,14,19,5,945
"622",103088,16,19,3,945
"623",103089,16,19,3,945
"624",103090,16,19,3,945
"625",103091,15,18,3,945
"626",103092,17,19,2,945
"627",103093,17,19,2,945
"628",103094,17,19,2,945
"629",103095,16,19,3,945
"630",103096,18,19,1,945
"631",103097,19,16,-3,945
"632",103098,21,13,-8,945
"633",103099,20,11,-9,945
"634",103100,20,8,-12,945
"635",103101,20,8,-12,945
"636",103102,20,8,-12,945
"637",103103,19,8,-11,945
"638",103104,20,8,-12,945
"639",103105,21,8,-13,945
"640",103106,21,8,-13,945
"641",103107,21,8,-13,945
"642",103108,21,8,-13,945
"643",103109,20,8,-12,945
"644",103110,20,8,-12,945
"645",103111,20,9,-11,945
"646",103112,23,12,-11,945
"647",103113,91,69,-22,945
"648",103114,89,68,-21,945
"649",103115,89,66,-23,945
"650",103116,63,45,-18,945
"651",103804,12,19,7,945
"652",103805,13,19,6,945
"653",103806,13,19,6,945
"654",103807,15,18,3,945
"655",103808,15,18,3,945
"656",103809,15,18,3,945
"657",103810,16,18,2,945
"658",103811,15,18,3,945
"659",103812,16,19,3,945
"660",103813,16,19,3,945
"661",103814,17,19,2,945
"662",103815,17,18,1,945
"663",103816,17,16,-1,945
"664",103817,18,12,-6,945
"665",103818,19,12,-7,945
"666",103819,20,9,-11,945
"667",103820,19,8,-11,945
"668",103821,18,8,-10,945
"669",103822,18,8,-10,945
"670",103823,18,8,-10,945
"671",103824,17,8,-9,945
"672",103825,19,8,-11,945
"673",103826,20,8,-12,945
"674",103827,20,8,-12,945
"675",103828,21,8,-13,945
"676",103829,21,8,-13,945
"677",103830,21,8,-13,945
"678",103831,22,8,-14,945
"679",103832,22,8,-14,945
"680",103833,23,8,-15,945
"681",103834,26,11,-15,945
"682",103835,64,38,-26,945
"683",103836,90,66,-24,945
"684",103837,89,66,-23,945
"685",103838,82,57,-25,945
"686",104524,12,19,7,945
"687",104525,13,19,6,945
"688",104526,14,19,5,945
"689",104527,14,18,4,945
"690",104528,14,18,4,945
"691",104529,15,18,3,945
"692",104530,15,18,3,945
"693",104531,15,18,3,945
"694",104532,15,17,2,945
"695",104533,16,18,2,945
"696",104534,16,18,2,945
"697",104535,16,15,-1,945
"698",104536,16,12,-4,945
"699",104537,16,11,-5,945
"700",104538,16,8,-8,945
"701",104539,17,8,-9,945
"702",104540,17,8,-9,945
"703",104541,17,8,-9,945
"704",104542,17,8,-9,945
"705",104543,15,8,-7,945
"706",104544,16,8,-8,945
"707",104545,18,8,-10,945
"708",104546,19,8,-11,945
"709",104547,20,8,-12,945
"710",104548,21,8,-13,945
"711",104549,22,8,-14,945
"712",104550,22,8,-14,945
"713",104551,22,8,-14,945
"714",104552,22,8,-14,945
"715",104553,21,8,-13,945
"716",104554,21,8,-13,945
"717",104555,22,8,-14,945
"718",104556,24,10,-14,945
"719",104557,26,12,-14,945
"720",104558,89,71,-18,945
"721",104559,86,68,-18,945
"722",104560,83,65,-18,945
"723",105245,14,18,4,945
"724",105246,14,18,4,945
"725",105247,14,18,4,945
"726",105248,14,18,4,945
"727",105249,14,18,4,945
"728",105250,14,18,4,945
"729",105251,14,17,3,945
"730",105252,14,17,3,945
"731",105253,15,15,0,945
"732",105254,16,13,-3,945
"733",105255,16,11,-5,945
"734",105256,16,11,-5,945
"735",105257,16,8,-8,945
"736",105258,15,7,-8,945
"737",105259,15,7,-8,945
"738",105260,14,7,-7,945
"739",105261,14,7,-7,945
"740",105262,16,8,-8,945
"741",105263,15,8,-7,945
"742",105264,14,8,-6,945
"743",105265,18,8,-10,945
"744",105266,19,8,-11,945
"745",105267,19,8,-11,945
"746",105268,20,8,-12,945
"747",105269,21,8,-13,945
"748",105270,21,8,-13,945
"749",105271,20,8,-12,945
"750",105272,20,8,-12,945
"751",105273,20,8,-12,945
"752",105274,20,8,-12,945
"753",105275,20,8,-12,945
"754",105276,20,8,-12,945
"755",105277,21,8,-13,945
"756",105278,22,9,-13,945
"757",105279,26,11,-15,945
"758",105280,89,71,-18,945
"759",105281,88,71,-17,945
"760",105282,90,71,-19,945
"761",105283,82,65,-17,945
"762",105965,14,18,4,945
"763",105966,14,18,4,945
"764",105967,14,18,4,945
"765",105968,14,18,4,945
"766",105969,14,18,4,945
"767",105970,14,17,3,945
"768",105971,14,11,-3,945
"769",105972,14,10,-4,945
"770",105973,14,10,-4,945
"771",105974,16,10,-6,945
"772",105975,16,8,-8,945
"773",105976,16,8,-8,945
"774",105977,15,7,-8,945
"775",105978,15,7,-8,945
"776",105979,14,7,-7,945
"777",105980,14,7,-7,945
"778",105981,14,7,-7,945
"779",105982,14,7,-7,945
"780",105983,15,8,-7,945
"781",105984,15,8,-7,945
"782",105987,19,8,-11,945
"783",105988,19,8,-11,945
"784",105989,20,8,-12,945
"785",105990,22,8,-14,945
"786",105991,20,8,-12,945
"787",105992,20,8,-12,945
"788",105993,20,8,-12,945
"789",105994,20,8,-12,945
"790",105995,20,8,-12,945
"791",105996,20,8,-12,945
"792",105997,20,8,-12,945
"793",105998,20,8,-12,945
"794",105999,22,8,-14,945
"795",106000,23,9,-14,945
"796",106001,24,11,-13,945
"797",106002,30,16,-14,945
"798",106003,94,73,-21,945
"799",106004,92,72,-20,945
"800",106005,87,70,-17,945
"801",106010,85,70,-15,945
"802",106011,86,72,-14,945
"803",106012,85,72,-13,945
"804",106686,14,17,3,945
"805",106687,14,17,3,945
"806",106688,14,17,3,945
"807",106689,14,17,3,945
"808",106690,14,11,-3,945
"809",106691,14,10,-4,945
"810",106692,14,9,-5,945
"811",106693,14,10,-4,945
"812",106694,15,8,-7,945
"813",106695,15,8,-7,945
"814",106696,15,7,-8,945
"815",106697,15,7,-8,945
"816",106698,14,7,-7,945
"817",106699,14,7,-7,945
"818",106700,13,7,-6,945
"819",106701,14,7,-7,945
"820",106702,13,7,-6,945
"821",106703,13,7,-6,945
"822",106709,20,8,-12,945
"823",106710,20,8,-12,945
"824",106711,20,8,-12,945
"825",106712,20,8,-12,945
"826",106713,20,8,-12,945
"827",106714,20,8,-12,945
"828",106715,20,8,-12,945
"829",106716,20,8,-12,945
"830",106717,20,8,-12,945
"831",106718,20,8,-12,945
"832",106719,22,8,-14,945
"833",106720,22,8,-14,945
"834",106721,22,9,-13,945
"835",106722,22,9,-13,945
"836",106723,25,14,-11,945
"837",106724,27,16,-11,945
"838",106725,94,74,-20,945
"839",106726,93,75,-18,945
"840",106727,92,75,-17,945
"841",106728,93,75,-18,945
"842",106729,94,77,-17,945
"843",106730,93,77,-16,945
"844",106731,76,62,-14,945
"845",106732,89,74,-15,945
"846",106733,91,78,-13,945
"847",106734,88,75,-13,945
"848",107407,14,9,-5,945
"849",107408,14,9,-5,945
"850",107409,14,9,-5,945
"851",107410,15,9,-6,945
"852",107411,15,8,-7,945
"853",107412,15,7,-8,945
"854",107413,15,7,-8,945
"855",107414,15,7,-8,945
"856",107415,14,7,-7,945
"857",107417,13,7,-6,945
"858",107418,14,7,-7,945
"859",107419,13,7,-6,945
"860",107420,12,7,-5,945
"861",107430,20,8,-12,945
"862",107431,20,8,-12,945
"863",107432,20,8,-12,945
"864",107433,20,8,-12,945
"865",107434,20,8,-12,945
"866",107435,20,8,-12,945
"867",107436,20,8,-12,945
"868",107437,20,8,-12,945
"869",107438,20,8,-12,945
"870",107439,22,9,-13,945
"871",107440,22,9,-13,945
"872",107441,22,9,-13,945
"873",107442,22,9,-13,945
"874",107443,21,12,-9,945
"875",107444,21,12,-9,945
"876",107445,21,12,-9,945
"877",107446,21,12,-9,945
"878",107447,22,13,-9,945
"879",107448,22,13,-9,945
"880",107449,23,13,-10,945
"881",107450,23,13,-10,945
"882",107451,49,34,-15,945
"883",107452,49,34,-15,945
"884",107453,85,69,-16,945
"885",107454,92,79,-13,945
"886",107455,88,75,-13,945
"887",108152,19,8,-11,945
"888",108153,19,8,-11,945
"889",108154,19,8,-11,945
"890",108155,19,8,-11,945
"891",108156,20,8,-12,945
"892",108157,20,8,-12,945
"893",108158,20,8,-12,945
"894",108159,21,9,-12,945
"895",108160,21,9,-12,945
"896",108161,22,9,-13,945
"897",108162,22,9,-13,945
"898",108163,22,9,-13,945
"899",108164,22,9,-13,945
"900",108165,21,9,-12,945
"901",108166,21,9,-12,945
"902",108167,21,9,-12,945
"903",108168,21,9,-12,945
"904",108169,21,10,-11,945
"905",108170,21,10,-11,945
"906",108171,21,11,-10,945
"907",108172,57,39,-18,945
"908",108173,62,42,-20,945
"909",108174,86,70,-16,945
"910",108175,92,79,-13,945
"911",108176,87,74,-13,945
"912",108875,18,8,-10,945
"913",108876,18,8,-10,945
"914",108877,18,8,-10,945
"915",108878,19,8,-11,945
"916",108879,21,8,-13,945
"917",108880,21,9,-12,945
"918",108881,22,9,-13,945
"919",108882,22,8,-14,945
"920",108883,22,8,-14,945
"921",108884,21,8,-13,945
"922",108885,21,8,-13,945
"923",108886,21,8,-13,945
"924",108887,21,8,-13,945
"925",108888,21,8,-13,945
"926",108889,21,9,-12,945
"927",108890,20,9,-11,945
"928",108891,20,10,-10,945
"929",108892,20,10,-10,945
"930",108893,21,10,-11,945
"931",108894,34,22,-12,945
"932",108895,84,64,-20,945
"933",108896,95,78,-17,945
"934",109597,18,8,-10,945
"935",109598,18,8,-10,945
"936",109599,19,8,-11,945
"937",109600,20,8,-12,945
"938",109601,22,8,-14,945
"939",109602,22,8,-14,945
"940",109603,21,8,-13,945
"941",109604,21,8,-13,945
"942",109605,21,8,-13,945
"943",109606,21,8,-13,945
"944",109607,21,8,-13,945
"945",109608,20,8,-12,945
"946",109609,20,8,-12,945
"947",109610,20,8,-12,945
"948",109611,20,8,-12,945
"949",109612,21,8,-13,945
"950",109613,21,8,-13,945
"951",109614,23,8,-15,945
"952",109615,24,9,-15,945
"953",110319,18,8,-10,945
"954",110320,18,8,-10,945
"955",110321,18,8,-10,945
"956",110322,19,8,-11,945
"957",110323,19,8,-11,945
"958",110324,19,8,-11,945
"959",110325,19,8,-11,945
"960",110326,19,8,-11,945
"961",110327,19,8,-11,945
"962",110328,18,8,-10,945
"963",110329,18,8,-10,945
"964",110330,18,8,-10,945
"965",110331,18,8,-10,945
"966",110332,18,8,-10,945
"967",110333,20,8,-12,945
"968",110334,20,8,-12,945
"969",111042,18,8,-10,945
"970",111043,18,8,-10,945
"971",111044,18,8,-10,945
"972",111045,18,8,-10,945
"973",111046,17,8,-9,945
"974",111047,17,8,-9,945
"975",111048,17,8,-9,945
"976",111049,18,8,-10,945
"977",111050,18,8,-10,945
"978",111051,18,8,-10,945
"979",111052,18,8,-10,945
"980",111053,20,8,-12,945
"981",111765,17,8,-9,945
"982",111766,17,8,-9,945
"983",111767,17,8,-9,945
"984",111768,17,8,-9,945
"985",111769,16,8,-8,945
"986",111770,16,8,-8,945
"987",111771,11,8,-3,945
"988",111772,11,8,-3,945
"989",34583,49,76,27,959
"990",34584,50,74,24,959
"991",34585,39,71,32,959
"992",35300,50,75,25,959
"993",35301,51,76,25,959
"994",35302,52,76,24,959
"995",35303,53,74,21,959
"996",35304,53,77,24,959
"997",35305,52,75,23,959
"998",35306,49,73,24,959
"999",35307,43,67,24,959
"1000",35308,8,16,8,959
"1001",36018,52,75,23,959
"1002",36019,53,76,23,959
"1003",36020,52,76,24,959
"1004",36021,55,77,22,959
"1005",36022,55,75,20,959
"1006",36023,57,76,19,959
"1007",36024,60,77,17,959
"1008",36025,61,74,13,959
"1009",36026,61,76,15,959
"1010",36027,59,71,12,959
"1011",36028,46,71,25,959
"1012",36029,29,61,32,959
"1013",36031,10,18,8,959
"1014",36032,30,64,34,959
"1015",36033,31,63,32,959
"1016",36034,31,62,31,959
"1017",36035,2,7,5,959
"1018",36036,29,58,29,959
"1019",36037,30,58,28,959
"1020",36038,24,50,26,959
"1021",36039,21,42,21,959
"1022",36736,54,72,18,959
"1023",36737,57,71,14,959
"1024",36738,57,73,16,959
"1025",36739,57,73,16,959
"1026",36740,55,73,18,959
"1027",36741,52,71,19,959
"1028",36742,57,74,17,959
"1029",36743,61,75,14,959
"1030",36744,62,74,12,959
"1031",36745,64,72,8,959
"1032",36746,66,71,5,959
"1033",36747,64,70,6,959
"1034",36748,63,72,9,959
"1035",36749,61,72,11,959
"1036",36750,58,71,13,959
"1037",36751,47,66,19,959
"1038",36752,44,65,21,959
"1039",36753,44,65,21,959
"1040",36754,42,66,24,959
"1041",36755,37,63,26,959
"1042",36756,39,61,22,959
"1043",36757,39,64,25,959
"1044",36758,34,64,30,959
"1045",36759,16,35,19,959
"1046",37454,60,69,9,959
"1047",37455,55,71,16,959
"1048",37456,56,72,16,959
"1049",37457,60,70,10,959
"1050",37458,59,70,11,959
"1051",37459,61,72,11,959
"1052",37460,59,72,13,959
"1053",37461,59,74,15,959
"1054",37462,58,72,14,959
"1055",37463,64,74,10,959
"1056",37464,68,73,5,959
"1057",37465,68,74,6,959
"1058",37466,66,72,6,959
"1059",37467,69,74,5,959
"1060",37468,64,73,9,959
"1061",37469,66,72,6,959
"1062",37470,59,69,10,959
"1063",37471,49,66,17,959
"1064",37472,43,65,22,959
"1065",37473,39,59,20,959
"1066",37474,38,64,26,959
"1067",37475,38,63,25,959
"1068",37476,38,63,25,959
"1069",37477,36,63,27,959
"1070",37478,36,64,28,959
"1071",37479,34,64,30,959
"1072",38172,62,71,9,959
"1073",38173,62,69,7,959
"1074",38174,64,69,5,959
"1075",38175,59,69,10,959
"1076",38176,61,69,8,959
"1077",38177,65,71,6,959
"1078",38178,63,74,11,959
"1079",38179,64,74,10,959
"1080",38180,56,71,15,959
"1081",38181,43,71,28,959
"1082",38182,57,71,14,959
"1083",38183,64,74,10,959
"1084",38184,67,75,8,959
"1085",38185,67,75,8,959
"1086",38186,68,74,6,959
"1087",38187,65,74,9,959
"1088",38188,64,71,7,959
"1089",38189,64,71,7,959
"1090",38190,59,68,9,959
"1091",38191,51,69,18,959
"1092",38192,38,69,31,959
"1093",38193,40,64,24,959
"1094",38194,40,65,25,959
"1095",38195,37,64,27,959
"1096",38196,34,63,29,959
"1097",38197,20,37,17,959
"1098",38890,65,70,5,959
"1099",38891,64,72,8,959
"1100",38892,64,71,7,959
"1101",38893,69,73,4,959
"1102",38894,67,72,5,959
"1103",38895,53,72,19,959
"1104",38896,51,70,19,959
"1105",38897,67,73,6,959
"1106",38898,67,74,7,959
"1107",38899,66,71,5,959
"1108",38900,65,69,4,959
"1109",38901,67,71,4,959
"1110",38902,64,71,7,959
"1111",38903,65,71,6,959
"1112",38904,68,75,7,959
"1113",38905,66,72,6,959
"1114",38906,67,74,7,959
"1115",38907,65,74,9,959
"1116",38908,64,74,10,959
"1117",38909,65,75,10,959
"1118",38910,63,73,10,959
"1119",38911,51,68,17,959
"1120",39608,57,69,12,959
"1121",39609,62,68,6,959
"1122",39610,67,69,2,959
"1123",39611,64,70,6,959
"1124",39612,66,72,6,959
"1125",39613,67,71,4,959
"1126",39614,68,71,3,959
"1127",39615,55,73,18,959
"1128",39616,53,72,19,959
"1129",39617,68,73,5,959
"1130",39618,68,73,5,959
"1131",39619,70,73,3,959
"1132",39620,66,72,6,959
"1133",39621,69,71,2,959
"1134",39622,66,71,5,959
"1135",39623,66,68,2,959
"1136",39624,66,71,5,959
"1137",39625,65,71,6,959
"1138",39626,66,73,7,959
"1139",39627,67,76,9,959
"1140",39628,67,74,7,959
"1141",39629,68,76,8,959
"1142",39630,48,70,22,959
"1143",40326,61,66,5,959
"1144",40327,62,66,4,959
"1145",40328,63,68,5,959
"1146",40329,65,67,2,959
"1147",40330,65,68,3,959
"1148",40331,66,70,4,959
"1149",40332,68,70,2,959
"1150",40333,67,71,4,959
"1151",40334,67,70,3,959
"1152",40335,67,71,4,959
"1153",40336,69,73,4,959
"1154",40337,70,72,2,959
"1155",40338,69,72,3,959
"1156",40339,69,72,3,959
"1157",40340,69,73,4,959
"1158",40341,68,70,2,959
"1159",40342,68,69,1,959
"1160",40343,67,71,4,959
"1161",40344,64,71,7,959
"1162",40345,67,72,5,959
"1163",40346,67,74,7,959
"1164",40347,71,78,7,959
"1165",40348,72,78,6,959
"1166",40349,68,79,11,959
"1167",41044,53,58,5,959
"1168",41045,58,64,6,959
"1169",41046,60,65,5,959
"1170",41047,61,66,5,959
"1171",41048,62,69,7,959
"1172",41049,66,68,2,959
"1173",41050,68,69,1,959
"1174",41051,65,69,4,959
"1175",41052,68,70,2,959
"1176",41053,67,69,2,959
"1177",41054,69,71,2,959
"1178",41055,70,72,2,959
"1179",41056,67,73,6,959
"1180",41057,71,74,3,959
"1181",41058,69,72,3,959
"1182",41059,70,75,5,959
"1183",41060,68,73,5,959
"1184",41061,68,70,2,959
"1185",41062,69,72,3,959
"1186",41063,68,72,4,959
"1187",41064,69,73,4,959
"1188",41065,69,75,6,959
"1189",41066,65,72,7,959
"1190",41067,68,76,8,959
"1191",41068,69,75,6,959
"1192",41069,69,76,7,959
"1193",41070,69,75,6,959
"1194",41098,48,68,20,959
"1195",41099,56,74,18,959
"1196",41100,54,73,19,959
"1197",41101,49,66,17,959
"1198",41102,6,5,-1,959
"1199",41104,45,58,13,959
"1200",41105,48,58,10,959
"1201",41106,21,30,9,959
"1202",41107,48,56,8,959
"1203",41108,45,54,9,959
"1204",41762,39,49,10,959
"1205",41763,47,53,6,959
"1206",41764,55,60,5,959
"1207",41765,63,63,0,959
"1208",41766,63,65,2,959
"1209",41767,64,65,1,959
"1210",41768,66,69,3,959
"1211",41769,69,71,2,959
"1212",41770,70,70,0,959
"1213",41771,68,71,3,959
"1214",41772,66,69,3,959
"1215",41773,69,71,2,959
"1216",41774,74,77,3,959
"1217",41775,73,76,3,959
"1218",41776,73,76,3,959
"1219",41777,76,75,-1,959
"1220",41778,72,73,1,959
"1221",41779,73,73,0,959
"1222",41780,70,73,3,959
"1223",41781,72,74,2,959
"1224",41782,70,72,2,959
"1225",41783,70,74,4,959
"1226",41784,68,75,7,959
"1227",41785,70,78,8,959
"1228",41786,70,78,8,959
"1229",41787,72,78,6,959
"1230",41788,72,76,4,959
"1231",41789,73,80,7,959
"1232",41790,76,83,7,959
"1233",41791,70,83,13,959
"1234",41816,74,82,8,959
"1235",41817,86,87,1,959
"1236",41818,78,79,1,959
"1237",41819,62,74,12,959
"1238",41820,47,57,10,959
"1239",41821,43,51,8,959
"1240",41822,43,50,7,959
"1241",41823,26,39,13,959
"1242",41824,66,75,9,959
"1243",41825,69,78,9,959
"1244",41826,76,79,3,959
"1245",41827,78,78,0,959
"1246",41828,72,78,6,959
"1247",41829,53,70,17,959
"1248",42481,13,13,0,959
"1249",42482,27,35,8,959
"1250",42483,50,54,4,959
"1251",42484,57,60,3,959
"1252",42485,62,61,-1,959
"1253",42486,63,62,-1,959
"1254",42487,61,61,0,959
"1255",42488,63,65,2,959
"1256",42489,69,69,0,959
"1257",42490,70,70,0,959
"1258",42491,68,72,4,959
"1259",42492,70,72,2,959
"1260",42493,70,73,3,959
"1261",42494,69,74,5,959
"1262",42495,70,74,4,959
"1263",42496,72,75,3,959
"1264",42497,75,75,0,959
"1265",42498,73,73,0,959
"1266",42499,72,74,2,959
"1267",42500,72,73,1,959
"1268",42501,74,75,1,959
"1269",42502,73,73,0,959
"1270",42503,70,72,2,959
"1271",42504,69,77,8,959
"1272",42505,73,81,8,959
"1273",42506,73,80,7,959
"1274",42507,76,81,5,959
"1275",42508,75,82,7,959
"1276",42509,77,84,7,959
"1277",42510,79,82,3,959
"1278",42511,77,81,4,959
"1279",42512,68,77,9,959
"1280",42516,24,36,12,959
"1281",42535,79,83,4,959
"1282",42536,86,87,1,959
"1283",42537,85,82,-3,959
"1284",42538,76,76,0,959
"1285",42542,0,0,0,959
"1286",42544,68,79,11,959
"1287",42545,76,82,6,959
"1288",42546,77,82,5,959
"1289",42547,80,83,3,959
"1290",42548,77,82,5,959
"1291",42549,72,79,7,959
"1292",42550,73,78,5,959
"1293",42551,63,60,-3,959
"1294",42552,60,58,-2,959
"1295",42553,54,56,2,959
"1296",42554,59,58,-1,959
"1297",42555,61,61,0,959
"1298",42556,60,57,-3,959
"1299",42557,43,64,21,959
"1300",42558,44,61,17,959
"1301",42561,7,9,2,959
"1302",42562,7,9,2,959
"1303",43201,5,6,1,959
"1304",43202,14,12,-2,959
"1305",43203,55,57,2,959
"1306",43204,64,58,-6,959
"1307",43205,60,56,-4,959
"1308",43206,64,61,-3,959
"1309",43207,65,62,-3,959
"1310",43208,66,63,-3,959
"1311",43209,68,65,-3,959
"1312",43210,69,66,-3,959
"1313",43211,70,73,3,959
"1314",43212,68,73,5,959
"1315",43213,68,73,5,959
"1316",43214,72,73,1,959
"1317",43215,72,74,2,959
"1318",43216,74,74,0,959
"1319",43217,72,74,2,959
"1320",43218,73,75,2,959
"1321",43219,73,72,-1,959
"1322",43220,75,75,0,959
"1323",43221,74,73,-1,959
"1324",43222,74,72,-2,959
"1325",43223,74,73,-1,959
"1326",43224,72,78,6,959
"1327",43225,74,81,7,959
"1328",43226,76,81,5,959
"1329",43227,78,82,4,959
"1330",43228,82,82,0,959
"1331",43229,81,82,1,959
"1332",43230,80,83,3,959
"1333",43231,76,79,3,959
"1334",43232,77,80,3,959
"1335",43233,77,78,1,959
"1336",43234,80,81,1,959
"1337",43235,82,83,1,959
"1338",43236,86,85,-1,959
"1339",43237,80,84,4,959
"1340",43253,79,84,5,959
"1341",43254,89,91,2,959
"1342",43255,92,89,-3,959
"1343",43256,84,80,-4,959
"1344",43257,86,84,-2,959
"1345",43258,86,84,-2,959
"1346",43259,68,74,6,959
"1347",43260,83,83,0,959
"1348",43261,89,89,0,959
"1349",43262,87,89,2,959
"1350",43263,84,85,1,959
"1351",43264,86,83,-3,959
"1352",43265,84,83,-1,959
"1353",43266,83,80,-3,959
"1354",43267,80,80,0,959
"1355",43268,73,76,3,959
"1356",43269,73,76,3,959
"1357",43270,74,73,-1,959
"1358",43271,84,77,-7,959
"1359",43272,85,76,-9,959
"1360",43273,84,78,-6,959
"1361",43274,71,67,-4,959
"1362",43275,69,66,-3,959
"1363",43276,74,71,-3,959
"1364",43277,84,81,-3,959
"1365",43278,84,79,-5,959
"1366",43279,84,82,-2,959
"1367",43280,83,83,0,959
"1368",43281,85,83,-2,959
"1369",43282,70,74,4,959
"1370",43922,6,6,0,959
"1371",43923,19,16,-3,959
"1372",43924,60,57,-3,959
"1373",43925,64,64,0,959
"1374",43926,64,62,-2,959
"1375",43927,65,63,-2,959
"1376",43928,66,64,-2,959
"1377",43929,68,67,-1,959
"1378",43930,70,67,-3,959
"1379",43931,71,71,0,959
"1380",43932,71,74,3,959
"1381",43933,71,77,6,959
"1382",43934,73,78,5,959
"1383",43935,72,74,2,959
"1384",43936,73,74,1,959
"1385",43937,74,78,4,959
"1386",43938,75,77,2,959
"1387",43939,73,73,0,959
"1388",43940,75,75,0,959
"1389",43941,74,76,2,959
"1390",43942,74,77,3,959
"1391",43943,75,78,3,959
"1392",43944,75,78,3,959
"1393",43945,74,81,7,959
"1394",43946,75,79,4,959
"1395",43947,76,78,2,959
"1396",43948,77,80,3,959
"1397",43949,79,80,1,959
"1398",43950,77,77,0,959
"1399",43951,73,79,6,959
"1400",43952,73,77,4,959
"1401",43953,74,78,4,959
"1402",43954,75,78,3,959
"1403",43955,82,84,2,959
"1404",43956,84,84,0,959
"1405",43957,79,83,4,959
"1406",43959,13,16,3,959
"1407",43960,16,19,3,959
"1408",43964,7,5,-2,959
"1409",43972,80,79,-1,959
"1410",43973,86,89,3,959
"1411",43974,89,91,2,959
"1412",43975,87,86,-1,959
"1413",43976,87,84,-3,959
"1414",43977,89,86,-3,959
"1415",43978,88,86,-2,959
"1416",43979,91,92,1,959
"1417",43980,88,90,2,959
"1418",43981,82,80,-2,959
"1419",43982,76,78,2,959
"1420",43983,78,78,0,959
"1421",43984,79,79,0,959
"1422",43985,80,80,0,959
"1423",43986,74,74,0,959
"1424",43987,76,77,1,959
"1425",43988,72,75,3,959
"1426",43989,58,53,-5,959
"1427",43990,46,40,-6,959
"1428",43991,15,18,3,959
"1429",43992,11,13,2,959
"1430",43993,11,14,3,959
"1431",43994,11,13,2,959
"1432",43995,12,12,0,959
"1433",43996,44,44,0,959
"1434",43997,64,64,0,959
"1435",43998,65,64,-1,959
"1436",43999,69,70,1,959
"1437",44000,74,74,0,959
"1438",44001,85,81,-4,959
"1439",44002,82,82,0,959
"1440",44003,80,82,2,959
"1441",44004,77,82,5,959
"1442",44007,18,33,15,959
"1443",44008,18,35,17,959
"1444",44009,9,17,8,959
"1445",44010,9,17,8,959
"1446",44643,8,5,-3,959
"1447",44644,26,17,-9,959
"1448",44645,29,42,13,959
"1449",44646,31,43,12,959
"1450",44647,65,54,-11,959
"1451",44648,66,51,-15,959
"1452",44649,70,62,-8,959
"1453",44650,71,64,-7,959
"1454",44651,71,69,-2,959
"1455",44652,68,67,-1,959
"1456",44653,71,73,2,959
"1457",44654,71,74,3,959
"1458",44655,74,77,3,959
"1459",44656,74,79,5,959
"1460",44657,73,77,4,959
"1461",44658,74,75,1,959
"1462",44659,73,73,0,959
"1463",44660,72,73,1,959
"1464",44661,72,75,3,959
"1465",44662,72,72,0,959
"1466",44663,73,74,1,959
"1467",44664,74,78,4,959
"1468",44665,77,80,3,959
"1469",44666,77,81,4,959
"1470",44667,77,81,4,959
"1471",44668,77,80,3,959
"1472",44669,79,81,2,959
"1473",44670,79,79,0,959
"1474",44671,73,78,5,959
"1475",44672,74,78,4,959
"1476",44673,76,79,3,959
"1477",44674,79,80,1,959
"1478",44675,81,82,1,959
"1479",44676,90,87,-3,959
"1480",44677,91,88,-3,959
"1481",44678,89,88,-1,959
"1482",44679,86,87,1,959
"1483",44680,87,86,-1,959
"1484",44681,88,87,-1,959
"1485",44682,88,89,1,959
"1486",44683,90,92,2,959
"1487",44684,88,92,4,959
"1488",44685,86,87,1,959
"1489",44686,84,86,2,959
"1490",44687,40,46,6,959
"1491",44693,91,93,2,959
"1492",44694,94,95,1,959
"1493",44695,92,92,0,959
"1494",44696,90,92,2,959
"1495",44697,93,94,1,959
"1496",44698,78,77,-1,959
"1497",44699,83,81,-2,959
"1498",44700,82,82,0,959
"1499",44701,79,79,0,959
"1500",44702,77,78,1,959
"1501",44703,75,76,1,959
"1502",44704,63,67,4,959
"1503",44705,25,27,2,959
"1504",44706,11,13,2,959
"1505",44707,8,10,2,959
"1506",44708,8,10,2,959
"1507",44709,9,10,1,959
"1508",44710,9,9,0,959
"1509",44711,9,9,0,959
"1510",44712,9,8,-1,959
"1511",44713,9,8,-1,959
"1512",44714,9,8,-1,959
"1513",44715,10,8,-2,959
"1514",44716,10,9,-1,959
"1515",44717,13,12,-1,959
"1516",44718,22,22,0,959
"1517",44719,49,45,-4,959
"1518",44720,72,69,-3,959
"1519",44721,73,75,2,959
"1520",44722,75,77,2,959
"1521",44723,79,78,-1,959
"1522",44724,84,86,2,959
"1523",44725,85,88,3,959
"1524",44726,80,87,7,959
"1525",44727,89,89,0,959
"1526",44728,91,92,1,959
"1527",44729,93,91,-2,959
"1528",44730,96,94,-2,959
"1529",44731,94,91,-3,959
"1530",45364,8,5,-3,959
"1531",45365,8,5,-3,959
"1532",45366,8,5,-3,959
"1533",45367,10,6,-4,959
"1534",45368,12,8,-4,959
"1535",45369,63,56,-7,959
"1536",45370,64,57,-7,959
"1537",45371,35,34,-1,959
"1538",45372,74,72,-2,959
"1539",45373,75,77,2,959
"1540",45374,74,79,5,959
"1541",45375,74,76,2,959
"1542",45376,74,75,1,959
"1543",45377,74,76,2,959
"1544",45378,75,79,4,959
"1545",45379,76,80,4,959
"1546",45380,75,79,4,959
"1547",45381,75,77,2,959
"1548",45382,73,76,3,959
"1549",45383,73,75,2,959
"1550",45384,74,78,4,959
"1551",45385,75,80,5,959
"1552",45386,75,80,5,959
"1553",45387,75,83,8,959
"1554",45388,80,85,5,959
"1555",45389,83,84,1,959
"1556",45390,80,84,4,959
"1557",45391,80,83,3,959
"1558",45392,78,80,2,959
"1559",45393,82,81,-1,959
"1560",45394,85,82,-3,959
"1561",45395,84,82,-2,959
"1562",45396,85,85,0,959
"1563",45397,90,90,0,959
"1564",45398,90,92,2,959
"1565",45399,90,91,1,959
"1566",45400,86,89,3,959
"1567",45401,89,92,3,959
"1568",45402,91,94,3,959
"1569",45403,93,94,1,959
"1570",45404,90,93,3,959
"1571",45405,87,89,2,959
"1572",45406,45,53,8,959
"1573",45411,91,94,3,959
"1574",45412,95,98,3,959
"1575",45413,93,94,1,959
"1576",45414,92,95,3,959
"1577",45415,92,93,1,959
"1578",45416,91,92,1,959
"1579",45417,92,92,0,959
"1580",45418,84,84,0,959
"1581",45419,81,82,1,959
"1582",45420,78,83,5,959
"1583",45421,81,84,3,959
"1584",45422,76,81,5,959
"1585",45423,77,81,4,959
"1586",45424,64,67,3,959
"1587",45425,11,13,2,959
"1588",45426,8,10,2,959
"1589",45427,8,10,2,959
"1590",45428,8,10,2,959
"1591",45429,9,10,1,959
"1592",45430,9,9,0,959
"1593",45431,9,9,0,959
"1594",45432,9,8,-1,959
"1595",45433,9,8,-1,959
"1596",45434,9,8,-1,959
"1597",45435,9,8,-1,959
"1598",45436,10,9,-1,959
"1599",45437,10,9,-1,959
"1600",45438,11,9,-2,959
"1601",45439,11,9,-2,959
"1602",45440,11,9,-2,959
"1603",45441,53,54,1,959
"1604",45442,74,79,5,959
"1605",45443,84,83,-1,959
"1606",45444,80,81,1,959
"1607",45445,77,76,-1,959
"1608",45446,91,93,2,959
"1609",45447,93,96,3,959
"1610",45448,95,96,1,959
"1611",45449,95,96,1,959
"1612",45450,98,97,-1,959
"1613",45451,101,98,-3,959
"1614",45452,102,101,-1,959
"1615",45453,92,94,2,959
"1616",46085,7,5,-2,959
"1617",46086,7,5,-2,959
"1618",46087,7,5,-2,959
"1619",46088,8,5,-3,959
"1620",46089,8,6,-2,959
"1621",46090,8,6,-2,959
"1622",46091,10,8,-2,959
"1623",46092,49,54,5,959
"1624",46093,73,71,-2,959
"1625",46094,74,71,-3,959
"1626",46095,73,62,-11,959
"1627",46096,75,62,-13,959
"1628",46097,76,78,2,959
"1629",46098,76,77,1,959
"1630",46099,77,77,0,959
"1631",46100,77,79,2,959
"1632",46101,78,81,3,959
"1633",46102,74,75,1,959
"1634",46103,77,79,2,959
"1635",46104,75,79,4,959
"1636",46105,79,80,1,959
"1637",46106,78,80,2,959
"1638",46107,82,80,-2,959
"1639",46108,82,81,-1,959
"1640",46109,88,85,-3,959
"1641",46110,86,82,-4,959
"1642",46111,87,83,-4,959
"1643",46112,85,83,-2,959
"1644",46113,87,82,-5,959
"1645",46114,88,83,-5,959
"1646",46115,89,86,-3,959
"1647",46116,89,86,-3,959
"1648",46117,90,88,-2,959
"1649",46118,92,89,-3,959
"1650",46119,92,89,-3,959
"1651",46120,92,91,-1,959
"1652",46121,92,92,0,959
"1653",46122,92,93,1,959
"1654",46123,92,96,4,959
"1655",46124,91,93,2,959
"1656",46125,88,90,2,959
"1657",46128,14,14,0,959
"1658",46129,93,96,3,959
"1659",46130,95,97,2,959
"1660",46131,98,100,2,959
"1661",46132,98,100,2,959
"1662",46133,95,99,4,959
"1663",46134,88,91,3,959
"1664",46135,91,92,1,959
"1665",46136,93,94,1,959
"1666",46137,90,89,-1,959
"1667",46138,87,86,-1,959
"1668",46139,81,83,2,959
"1669",46140,80,83,3,959
"1670",46141,61,69,8,959
"1671",46142,54,65,11,959
"1672",46143,17,19,2,959
"1673",46144,11,13,2,959
"1674",46145,9,10,1,959
"1675",46146,9,9,0,959
"1676",46147,9,10,1,959
"1677",46148,9,10,1,959
"1678",46149,9,9,0,959
"1679",46150,9,8,-1,959
"1680",46151,8,8,0,959
"1681",46152,9,8,-1,959
"1682",46153,9,9,0,959
"1683",46154,9,9,0,959
"1684",46155,9,9,0,959
"1685",46156,9,9,0,959
"1686",46157,10,9,-1,959
"1687",46158,11,10,-1,959
"1688",46159,11,10,-1,959
"1689",46160,11,10,-1,959
"1690",46161,10,11,1,959
"1691",46162,10,11,1,959
"1692",46163,10,12,2,959
"1693",46164,48,47,-1,959
"1694",46165,67,66,-1,959
"1695",46166,70,69,-1,959
"1696",46167,97,101,4,959
"1697",46168,100,100,0,959
"1698",46169,95,97,2,959
"1699",46170,99,98,-1,959
"1700",46171,101,98,-3,959
"1701",46172,100,98,-2,959
"1702",46173,102,100,-2,959
"1703",46174,97,96,-1,959
"1704",46175,10,20,10,959
"1705",46807,7,5,-2,959
"1706",46808,7,5,-2,959
"1707",46809,8,6,-2,959
"1708",46810,8,6,-2,959
"1709",46811,8,5,-3,959
"1710",46812,11,13,2,959
"1711",46813,71,69,-2,959
"1712",46814,78,74,-4,959
"1713",46815,75,63,-12,959
"1714",46816,73,61,-12,959
"1715",46817,75,62,-13,959
"1716",46818,81,82,1,959
"1717",46819,81,84,3,959
"1718",46820,81,82,1,959
"1719",46821,81,84,3,959
"1720",46822,78,78,0,959
"1721",46823,81,81,0,959
"1722",46824,79,81,2,959
"1723",46825,81,81,0,959
"1724",46826,81,82,1,959
"1725",46827,80,79,-1,959
"1726",46828,81,80,-1,959
"1727",46829,86,82,-4,959
"1728",46830,87,86,-1,959
"1729",46831,89,87,-2,959
"1730",46832,87,86,-1,959
"1731",46833,86,83,-3,959
"1732",46834,85,82,-3,959
"1733",46835,86,86,0,959
"1734",46836,87,89,2,959
"1735",46837,91,92,1,959
"1736",46838,93,92,-1,959
"1737",46839,92,90,-2,959
"1738",46840,93,90,-3,959
"1739",46841,91,90,-1,959
"1740",46842,93,91,-2,959
"1741",46843,94,95,1,959
"1742",46844,92,93,1,959
"1743",46845,11,11,0,959
"1744",46847,88,92,4,959
"1745",46848,96,100,4,959
"1746",46849,97,101,4,959
"1747",46850,74,74,0,959
"1748",46851,98,101,3,959
"1749",46852,90,92,2,959
"1750",46853,92,91,-1,959
"1751",46854,94,95,1,959
"1752",46855,94,97,3,959
"1753",46856,95,97,2,959
"1754",46857,90,93,3,959
"1755",46858,88,90,2,959
"1756",46859,81,82,1,959
"1757",46860,74,69,-5,959
"1758",46861,11,16,5,959
"1759",46862,8,10,2,959
"1760",46863,8,10,2,959
"1761",46864,8,10,2,959
"1762",46865,9,10,1,959
"1763",46866,9,9,0,959
"1764",46867,9,9,0,959
"1765",46868,9,9,0,959
"1766",46869,8,8,0,959
"1767",46870,8,8,0,959
"1768",46871,9,8,-1,959
"1769",46872,8,8,0,959
"1770",46873,8,9,1,959
"1771",46874,8,9,1,959
"1772",46875,9,9,0,959
"1773",46876,9,9,0,959
"1774",46877,9,9,0,959
"1775",46878,10,9,-1,959
"1776",46879,11,9,-2,959
"1777",46880,11,10,-1,959
"1778",46881,10,11,1,959
"1779",46882,10,11,1,959
"1780",46883,10,12,2,959
"1781",46884,10,12,2,959
"1782",46885,10,12,2,959
"1783",46886,10,12,2,959
"1784",46887,19,19,0,959
"1785",46888,89,91,2,959
"1786",46889,97,99,2,959
"1787",46890,96,95,-1,959
"1788",46891,106,103,-3,959
"1789",46892,109,107,-2,959
"1790",46893,108,106,-2,959
"1791",46894,106,108,2,959
"1792",46895,95,100,5,959
"1793",47527,5,5,0,959
"1794",47528,7,5,-2,959
"1795",47529,7,5,-2,959
"1796",47530,7,5,-2,959
"1797",47531,8,5,-3,959
"1798",47532,8,6,-2,959
"1799",47533,20,22,2,959
"1800",47534,55,56,1,959
"1801",47535,70,75,5,959
"1802",47536,70,75,5,959
"1803",47537,74,73,-1,959
"1804",47538,72,70,-2,959
"1805",47539,75,77,2,959
"1806",47540,76,78,2,959
"1807",47541,85,88,3,959
"1808",47542,87,88,1,959
"1809",47543,84,83,-1,959
"1810",47544,82,81,-1,959
"1811",47545,81,80,-1,959
"1812",47546,82,80,-2,959
"1813",47547,87,81,-6,959
"1814",47548,87,82,-5,959
"1815",47549,86,84,-2,959
"1816",47550,88,83,-5,959
"1817",47551,88,83,-5,959
"1818",47552,89,84,-5,959
"1819",47553,88,86,-2,959
"1820",47554,86,85,-1,959
"1821",47555,89,89,0,959
"1822",47556,90,90,0,959
"1823",47557,91,94,3,959
"1824",47558,92,94,2,959
"1825",47559,91,91,0,959
"1826",47560,96,94,-2,959
"1827",47561,94,93,-1,959
"1828",47562,94,94,0,959
"1829",47563,95,94,-1,959
"1830",47564,64,67,3,959
"1831",47565,102,103,1,959
"1832",47566,103,103,0,959
"1833",47567,98,98,0,959
"1834",47568,92,91,-1,959
"1835",47569,92,91,-1,959
"1836",47570,97,96,-1,959
"1837",47571,97,100,3,959
"1838",47572,96,97,1,959
"1839",47573,96,99,3,959
"1840",47574,96,97,1,959
"1841",47575,92,91,-1,959
"1842",47576,94,94,0,959
"1843",47577,91,89,-2,959
"1844",47578,55,50,-5,959
"1845",47579,11,11,0,959
"1846",47580,8,8,0,959
"1847",47581,8,9,1,959
"1848",47582,8,9,1,959
"1849",47583,8,10,2,959
"1850",47584,8,10,2,959
"1851",47585,9,10,1,959
"1852",47586,9,9,0,959
"1853",47587,7,9,2,959
"1854",47588,7,9,2,959
"1855",47589,8,9,1,959
"1856",47590,8,9,1,959
"1857",47591,9,9,0,959
"1858",47592,8,9,1,959
"1859",47593,8,8,0,959
"1860",47594,8,8,0,959
"1861",47595,9,9,0,959
"1862",47596,9,9,0,959
"1863",47597,10,9,-1,959
"1864",47598,10,9,-1,959
"1865",47599,10,9,-1,959
"1866",47600,9,9,0,959
"1867",47601,9,10,1,959
"1868",47602,9,10,1,959
"1869",47603,8,9,1,959
"1870",47604,8,9,1,959
"1871",47605,8,11,3,959
"1872",47606,8,11,3,959
"1873",47607,11,12,1,959
"1874",47608,71,73,2,959
"1875",47609,107,105,-2,959
"1876",47610,102,100,-2,959
"1877",47611,107,106,-1,959
"1878",47612,108,109,1,959
"1879",47613,93,95,2,959
"1880",47614,101,105,4,959
"1881",47615,104,109,5,959
"1882",47616,104,108,4,959
"1883",48248,6,5,-1,959
"1884",48249,7,5,-2,959
"1885",48250,7,5,-2,959
"1886",48251,8,5,-3,959
"1887",48252,8,6,-2,959
"1888",48253,8,6,-2,959
"1889",48254,8,6,-2,959
"1890",48255,15,13,-2,959
"1891",48256,15,13,-2,959
"1892",48257,30,33,3,959
"1893",48258,71,66,-5,959
"1894",48259,76,67,-9,959
"1895",48260,84,87,3,959
"1896",48261,86,88,2,959
"1897",48262,80,80,0,959
"1898",48263,80,66,-14,959
"1899",48264,75,63,-12,959
"1900",48265,79,78,-1,959
"1901",48266,82,79,-3,959
"1902",48267,87,82,-5,959
"1903",48268,88,83,-5,959
"1904",48269,87,85,-2,959
"1905",48270,87,85,-2,959
"1906",48271,87,85,-2,959
"1907",48272,88,86,-2,959
"1908",48273,88,86,-2,959
"1909",48274,88,87,-1,959
"1910",48275,88,89,1,959
"1911",48276,91,93,2,959
"1912",48277,95,97,2,959
"1913",48278,96,99,3,959
"1914",48279,98,99,1,959
"1915",48280,96,96,0,959
"1916",48283,62,63,1,959
"1917",48284,103,101,-2,959
"1918",48285,103,102,-1,959
"1919",48286,100,100,0,959
"1920",48287,100,103,3,959
"1921",48288,91,92,1,959
"1922",48289,96,94,-2,959
"1923",48290,94,97,3,959
"1924",48291,100,105,5,959
"1925",48292,101,102,1,959
"1926",48293,97,98,1,959
"1927",48294,95,99,4,959
"1928",48295,94,93,-1,959
"1929",48296,77,74,-3,959
"1930",48297,12,10,-2,959
"1931",48298,9,6,-3,959
"1932",48299,8,8,0,959
"1933",48300,8,8,0,959
"1934",48301,8,9,1,959
"1935",48302,8,9,1,959
"1936",48303,8,10,2,959
"1937",48304,8,10,2,959
"1938",48305,7,9,2,959
"1939",48306,7,9,2,959
"1940",48307,7,9,2,959
"1941",48308,7,9,2,959
"1942",48309,7,9,2,959
"1943",48310,7,9,2,959
"1944",48311,8,9,1,959
"1945",48312,8,9,1,959
"1946",48313,8,8,0,959
"1947",48314,8,8,0,959
"1948",48316,12,12,0,959
"1949",48317,10,9,-1,959
"1950",48318,10,9,-1,959
"1951",48319,9,9,0,959
"1952",48320,9,10,1,959
"1953",48321,9,10,1,959
"1954",48322,9,10,1,959
"1955",48323,8,9,1,959
"1956",48324,8,9,1,959
"1957",48325,8,11,3,959
"1958",48326,8,11,3,959
"1959",48327,11,12,1,959
"1960",48328,11,12,1,959
"1961",48329,85,81,-4,959
"1962",48330,100,94,-6,959
"1963",48331,110,111,1,959
"1964",48332,112,112,0,959
"1965",48333,111,113,2,959
"1966",48334,110,112,2,959
"1967",48335,109,113,4,959
"1968",48336,107,110,3,959
"1969",48337,99,104,5,959
"1970",48338,52,59,7,959
"1971",48948,1,5,4,959
"1972",48949,1,5,4,959
"1973",48950,1,5,4,959
"1974",48951,1,5,4,959
"1975",48952,1,5,4,959
"1976",48968,5,2,-3,959
"1977",48969,6,2,-4,959
"1978",48970,6,2,-4,959
"1979",48971,6,2,-4,959
"1980",48972,6,3,-3,959
"1981",48973,6,3,-3,959
"1982",48974,7,3,-4,959
"1983",48975,7,5,-2,959
"1984",48976,7,5,-2,959
"1985",48977,7,6,-1,959
"1986",48978,7,6,-1,959
"1987",48979,8,7,-1,959
"1988",48980,12,14,2,959
"1989",48981,12,14,2,959
"1990",48982,11,12,1,959
"1991",48983,69,76,7,959
"1992",48984,69,76,7,959
"1993",48985,81,80,-1,959
"1994",48986,80,77,-3,959
"1995",48987,85,81,-4,959
"1996",48988,85,82,-3,959
"1997",48989,85,83,-2,959
"1998",48990,85,83,-2,959
"1999",48991,89,86,-3,959
"2000",48992,89,89,0,959
"2001",48993,87,85,-2,959
"2002",48994,95,90,-5,959
"2003",48995,98,95,-3,959
"2004",48996,96,96,0,959
"2005",48997,89,93,4,959
"2006",48998,91,95,4,959
"2007",48999,99,100,1,959
"2008",49000,99,100,1,959
"2009",49001,101,100,-1,959
"2010",49002,103,102,-1,959
"2011",49003,104,103,-1,959
"2012",49004,105,104,-1,959
"2013",49005,101,104,3,959
"2014",49006,99,101,2,959
"2015",49007,100,98,-2,959
"2016",49008,91,91,0,959
"2017",49009,101,101,0,959
"2018",49010,101,102,1,959
"2019",49011,88,88,0,959
"2020",49012,69,75,6,959
"2021",49013,56,59,3,959
"2022",49014,48,48,0,959
"2023",49015,8,8,0,959
"2024",49016,8,8,0,959
"2025",49017,8,9,1,959
"2026",49018,8,9,1,959
"2027",49019,8,9,1,959
"2028",49020,8,9,1,959
"2029",49021,8,9,1,959
"2030",49022,8,9,1,959
"2031",49023,8,9,1,959
"2032",49024,7,9,2,959
"2033",49025,7,9,2,959
"2034",49026,7,9,2,959
"2035",49027,7,9,2,959
"2036",49037,11,10,-1,959
"2037",49038,8,8,0,959
"2038",49039,8,9,1,959
"2039",49040,9,10,1,959
"2040",49041,9,10,1,959
"2041",49042,9,10,1,959
"2042",49043,8,9,1,959
"2043",49044,8,9,1,959
"2044",49045,8,9,1,959
"2045",49046,8,9,1,959
"2046",49047,8,9,1,959
"2047",49048,8,9,1,959
"2048",49049,14,14,0,959
"2049",49050,78,76,-2,959
"2050",49051,111,113,2,959
"2051",49052,110,113,3,959
"2052",49053,107,110,3,959
"2053",49054,103,107,4,959
"2054",49055,99,104,5,959
"2055",49056,109,110,1,959
"2056",49057,109,110,1,959
"2057",49058,110,114,4,959
"2058",49059,110,112,2,959
"2059",49060,60,62,2,959
"2060",49666,1,5,4,959
"2061",49667,1,5,4,959
"2062",49668,1,5,4,959
"2063",49669,1,5,4,959
"2064",49670,1,5,4,959
"2065",49671,1,5,4,959
"2066",49672,1,5,4,959
"2067",49673,2,5,3,959
"2068",49674,2,5,3,959
"2069",49675,2,5,3,959
"2070",49676,2,5,3,959
"2071",49681,2,2,0,959
"2072",49682,2,2,0,959
"2073",49683,2,2,0,959
"2074",49684,2,2,0,959
"2075",49685,2,2,0,959
"2076",49686,2,2,0,959
"2077",49687,2,2,0,959
"2078",49688,4,2,-2,959
"2079",49689,6,2,-4,959
"2080",49690,6,2,-4,959
"2081",49691,6,2,-4,959
"2082",49692,6,3,-3,959
"2083",49693,6,3,-3,959
"2084",49694,6,3,-3,959
"2085",49695,7,5,-2,959
"2086",49696,7,5,-2,959
"2087",49697,7,6,-1,959
"2088",49698,7,6,-1,959
"2089",49699,8,6,-2,959
"2090",49700,8,6,-2,959
"2091",49701,8,6,-2,959
"2092",49702,8,6,-2,959
"2093",49703,13,10,-3,959
"2094",49704,58,56,-2,959
"2095",49705,74,63,-11,959
"2096",49706,78,66,-12,959
"2097",49707,80,78,-2,959
"2098",49708,82,79,-3,959
"2099",49709,86,82,-4,959
"2100",49710,86,82,-4,959
"2101",49711,89,89,0,959
"2102",49712,98,97,-1,959
"2103",49713,97,95,-2,959
"2104",49714,99,96,-3,959
"2105",49715,94,92,-2,959
"2106",49716,97,97,0,959
"2107",49717,101,98,-3,959
"2108",49718,103,100,-3,959
"2109",49719,102,100,-2,959
"2110",49720,102,101,-1,959
"2111",49721,103,101,-2,959
"2112",49722,103,101,-2,959
"2113",49723,103,103,0,959
"2114",49724,96,90,-6,959
"2115",49725,95,96,1,959
"2116",49726,96,98,2,959
"2117",49727,94,97,3,959
"2118",49728,81,82,1,959
"2119",49729,71,72,1,959
"2120",49730,27,18,-9,959
"2121",49731,10,14,4,959
"2122",49732,10,13,3,959
"2123",49733,7,7,0,959
"2124",49734,7,8,1,959
"2125",49735,8,8,0,959
"2126",49736,8,8,0,959
"2127",49737,8,9,1,959
"2128",49738,8,9,1,959
"2129",49739,8,9,1,959
"2130",49740,8,9,1,959
"2131",49741,8,9,1,959
"2132",49742,8,9,1,959
"2133",49743,7,9,2,959
"2134",49744,7,9,2,959
"2135",49745,7,9,2,959
"2136",49746,7,9,2,959
"2137",49758,8,8,0,959
"2138",49759,8,9,1,959
"2139",49760,8,10,2,959
"2140",49761,7,10,3,959
"2141",49762,9,10,1,959
"2142",49763,8,9,1,959
"2143",49764,8,9,1,959
"2144",49765,8,9,1,959
"2145",49766,8,9,1,959
"2146",49767,8,9,1,959
"2147",49768,8,9,1,959
"2148",49769,11,10,-1,959
"2149",49770,15,16,1,959
"2150",49771,83,81,-2,959
"2151",49772,105,104,-1,959
"2152",49773,111,115,4,959
"2153",49774,108,112,4,959
"2154",49775,95,98,3,959
"2155",49776,107,110,3,959
"2156",49777,108,110,2,959
"2157",49778,110,111,1,959
"2158",49779,106,110,4,959
"2159",49780,108,111,3,959
"2160",49781,104,108,4,959
"2161",50385,1,5,4,959
"2162",50386,1,5,4,959
"2163",50387,1,5,4,959
"2164",50388,1,5,4,959
"2165",50389,1,5,4,959
"2166",50390,1,5,4,959
"2167",50391,1,5,4,959
"2168",50392,1,5,4,959
"2169",50393,2,6,4,959
"2170",50394,3,6,3,959
"2171",50395,3,6,3,959
"2172",50396,3,6,3,959
"2173",50397,3,5,2,959
"2174",50398,3,5,2,959
"2175",50399,0,3,3,959
"2176",50400,1,3,2,959
"2177",50401,2,2,0,959
"2178",50402,2,2,0,959
"2179",50403,2,2,0,959
"2180",50404,2,2,0,959
"2181",50405,2,1,-1,959
"2182",50406,2,1,-1,959
"2183",50407,2,2,0,959
"2184",50408,2,2,0,959
"2185",50409,1,2,1,959
"2186",50410,1,2,1,959
"2187",50411,1,2,1,959
"2188",50412,1,3,2,959
"2189",50413,1,3,2,959
"2190",50414,1,3,2,959
"2191",50415,5,3,-2,959
"2192",50416,5,3,-2,959
"2193",50417,7,3,-4,959
"2194",50418,7,3,-4,959
"2195",50419,8,3,-5,959
"2196",50420,8,3,-5,959
"2197",50421,8,3,-5,959
"2198",50422,11,7,-4,959
"2199",50423,13,9,-4,959
"2200",50424,13,9,-4,959
"2201",50425,36,30,-6,959
"2202",50426,73,69,-4,959
"2203",50427,81,78,-3,959
"2204",50428,85,82,-3,959
"2205",50429,85,84,-1,959
"2206",50430,93,90,-3,959
"2207",50431,98,97,-1,959
"2208",50432,99,98,-1,959
"2209",50433,102,100,-2,959
"2210",50434,103,101,-2,959
"2211",50435,103,101,-2,959
"2212",50436,102,101,-1,959
"2213",50437,102,102,0,959
"2214",50438,102,102,0,959
"2215",50439,102,102,0,959
"2216",50440,103,101,-2,959
"2217",50441,105,103,-2,959
"2218",50442,106,104,-2,959
"2219",50443,105,103,-2,959
"2220",50444,92,88,-4,959
"2221",50445,69,68,-1,959
"2222",50446,68,66,-2,959
"2223",50447,14,10,-4,959
"2224",50448,12,8,-4,959
"2225",50449,7,7,0,959
"2226",50450,7,7,0,959
"2227",50451,7,7,0,959
"2228",50452,7,7,0,959
"2229",50453,8,8,0,959
"2230",50454,8,9,1,959
"2231",50455,8,9,1,959
"2232",50456,8,9,1,959
"2233",50457,7,9,2,959
"2234",50458,6,9,3,959
"2235",50459,8,11,3,959
"2236",50460,8,11,3,959
"2237",50461,6,9,3,959
"2238",50462,6,9,3,959
"2239",50463,6,9,3,959
"2240",50464,6,9,3,959
"2241",50479,7,10,3,959
"2242",50480,7,10,3,959
"2243",50481,7,10,3,959
"2244",50482,7,10,3,959
"2245",50483,7,9,2,959
"2246",50484,7,9,2,959
"2247",50485,7,9,2,959
"2248",50486,11,11,0,959
"2249",50487,12,11,-1,959
"2250",50488,10,10,0,959
"2251",50489,11,11,0,959
"2252",50490,11,11,0,959
"2253",50491,16,16,0,959
"2254",50492,80,82,2,959
"2255",50493,116,118,2,959
"2256",50494,115,116,1,959
"2257",50495,114,116,2,959
"2258",50496,115,115,0,959
"2259",50497,115,115,0,959
"2260",50498,115,115,0,959
"2261",50499,112,113,1,959
"2262",50500,112,113,1,959
"2263",51103,1,5,4,959
"2264",51104,1,5,4,959
"2265",51105,1,5,4,959
"2266",51106,1,5,4,959
"2267",51107,1,5,4,959
"2268",51108,1,5,4,959
"2269",51109,1,5,4,959
"2270",51110,1,5,4,959
"2271",51111,1,5,4,959
"2272",51112,1,5,4,959
"2273",51113,7,11,4,959
"2274",51114,8,11,3,959
"2275",51115,3,6,3,959
"2276",51116,3,6,3,959
"2277",51117,8,11,3,959
"2278",51118,13,15,2,959
"2279",51119,12,14,2,959
"2280",51120,1,3,2,959
"2281",51121,6,8,2,959
"2282",51122,2,2,0,959
"2283",51123,2,2,0,959
"2284",51124,2,2,0,959
"2285",51125,2,1,-1,959
"2286",51126,2,1,-1,959
"2287",51127,2,2,0,959
"2288",51128,2,2,0,959
"2289",51129,1,2,1,959
"2290",51130,1,2,1,959
"2291",51131,1,2,1,959
"2292",51132,1,3,2,959
"2293",51133,1,3,2,959
"2294",51134,2,3,1,959
"2295",51135,5,3,-2,959
"2296",51136,5,3,-2,959
"2297",51137,7,3,-4,959
"2298",51138,7,3,-4,959
"2299",51139,8,3,-5,959
"2300",51140,8,3,-5,959
"2301",51141,8,3,-5,959
"2302",51142,8,4,-4,959
"2303",51143,15,11,-4,959
"2304",51144,16,12,-4,959
"2305",51145,25,20,-5,959
"2306",51146,35,33,-2,959
"2307",51147,104,102,-2,959
"2308",51148,105,102,-3,959
"2309",51149,104,103,-1,959
"2310",51150,103,102,-1,959
"2311",51151,99,98,-1,959
"2312",51152,95,94,-1,959
"2313",51153,87,86,-1,959
"2314",51154,102,99,-3,959
"2315",51155,106,105,-1,959
"2316",51156,106,106,0,959
"2317",51157,101,100,-1,959
"2318",51158,95,95,0,959
"2319",51159,93,93,0,959
"2320",51160,95,94,-1,959
"2321",51161,95,93,-2,959
"2322",51162,84,80,-4,959
"2323",51163,27,24,-3,959
"2324",51164,13,6,-7,959
"2325",51165,10,3,-7,959
"2326",51166,9,4,-5,959
"2327",51167,9,5,-4,959
"2328",51168,9,5,-4,959
"2329",51169,7,7,0,959
"2330",51170,7,7,0,959
"2331",51171,7,7,0,959
"2332",51172,7,7,0,959
"2333",51173,7,8,1,959
"2334",51174,7,9,2,959
"2335",51175,7,9,2,959
"2336",51176,7,9,2,959
"2337",51177,6,9,3,959
"2338",51178,6,9,3,959
"2339",51179,6,9,3,959
"2340",51180,6,9,3,959
"2341",51181,6,9,3,959
"2342",51182,6,9,3,959
"2343",51201,7,10,3,959
"2344",51202,7,10,3,959
"2345",51203,7,9,2,959
"2346",51204,7,9,2,959
"2347",51205,7,9,2,959
"2348",51206,8,9,1,959
"2349",51207,11,11,0,959
"2350",51208,11,11,0,959
"2351",51209,11,11,0,959
"2352",51210,11,11,0,959
"2353",51211,12,11,-1,959
"2354",51212,21,20,-1,959
"2355",51213,83,85,2,959
"2356",51214,115,117,2,959
"2357",51215,114,116,2,959
"2358",51216,114,116,2,959
"2359",51217,115,116,1,959
"2360",51822,1,5,4,959
"2361",51823,1,5,4,959
"2362",51824,1,5,4,959
"2363",51825,2,5,3,959
"2364",51826,2,5,3,959
"2365",51827,2,5,3,959
"2366",51828,2,5,3,959
"2367",51829,1,5,4,959
"2368",51830,1,5,4,959
"2369",51831,1,5,4,959
"2370",51832,1,5,4,959
"2371",51833,1,5,4,959
"2372",51834,1,5,4,959
"2373",51835,2,5,3,959
"2374",51836,2,5,3,959
"2375",51837,3,5,2,959
"2376",51838,4,6,2,959
"2377",51839,6,8,2,959
"2378",51840,5,8,3,959
"2379",51841,5,5,0,959
"2380",51842,3,4,1,959
"2381",51843,2,2,0,959
"2382",51844,2,1,-1,959
"2383",51845,1,1,0,959
"2384",51846,1,1,0,959
"2385",51847,1,2,1,959
"2386",51848,1,2,1,959
"2387",51849,6,2,-4,959
"2388",51850,6,2,-4,959
"2389",51851,6,2,-4,959
"2390",51852,6,2,-4,959
"2391",51853,6,3,-3,959
"2392",51854,6,3,-3,959
"2393",51855,2,3,1,959
"2394",51856,2,3,1,959
"2395",51857,2,3,1,959
"2396",51858,2,3,1,959
"2397",51859,2,3,1,959
"2398",51860,2,4,2,959
"2399",51861,9,5,-4,959
"2400",51862,14,9,-5,959
"2401",51863,22,19,-3,959
"2402",51864,103,99,-4,959
"2403",51865,104,101,-3,959
"2404",51866,103,103,0,959
"2405",51867,97,98,1,959
"2406",51868,101,100,-1,959
"2407",51869,99,99,0,959
"2408",51870,97,97,0,959
"2409",51871,97,96,-1,959
"2410",51872,97,95,-2,959
"2411",51873,93,91,-2,959
"2412",51874,89,88,-1,959
"2413",51875,18,16,-2,959
"2414",51876,13,10,-3,959
"2415",51877,11,8,-3,959
"2416",51878,11,8,-3,959
"2417",51879,8,3,-5,959
"2418",51880,8,3,-5,959
"2419",51881,9,3,-6,959
"2420",51882,9,3,-6,959
"2421",51883,7,6,-1,959
"2422",51884,7,6,-1,959
"2423",51885,7,6,-1,959
"2424",51886,7,7,0,959
"2425",51887,7,7,0,959
"2426",51888,7,7,0,959
"2427",51889,7,8,1,959
"2428",51890,7,8,1,959
"2429",51891,7,8,1,959
"2430",51892,7,8,1,959
"2431",51893,7,8,1,959
"2432",51894,7,9,2,959
"2433",51895,7,9,2,959
"2434",51896,6,9,3,959
"2435",51897,6,9,3,959
"2436",51898,6,9,3,959
"2437",51899,6,9,3,959
"2438",51900,6,9,3,959
"2439",51922,7,10,3,959
"2440",51923,7,10,3,959
"2441",51924,7,10,3,959
"2442",51925,8,10,2,959
"2443",51926,9,11,2,959
"2444",51927,13,14,1,959
"2445",51928,14,14,0,959
"2446",51929,15,15,0,959
"2447",52541,3,7,4,959
"2448",52542,1,5,4,959
"2449",52543,2,5,3,959
"2450",52544,2,5,3,959
"2451",52545,2,5,3,959
"2452",52546,2,5,3,959
"2453",52547,2,5,3,959
"2454",52548,2,5,3,959
"2455",52549,1,5,4,959
"2456",52550,1,5,4,959
"2457",52551,1,5,4,959
"2458",52552,1,5,4,959
"2459",52553,2,4,2,959
"2460",52554,2,4,2,959
"2461",52555,2,2,0,959
"2462",52556,2,2,0,959
"2463",52557,2,2,0,959
"2464",52558,2,2,0,959
"2465",52559,2,2,0,959
"2466",52560,4,4,0,959
"2467",52561,5,5,0,959
"2468",52562,4,4,0,959
"2469",52563,3,2,-1,959
"2470",52564,3,1,-2,959
"2471",52565,1,1,0,959
"2472",52566,2,1,-1,959
"2473",52567,2,2,0,959
"2474",52568,2,2,0,959
"2475",52569,6,2,-4,959
"2476",52570,6,2,-4,959
"2477",52571,6,2,-4,959
"2478",52572,6,2,-4,959
"2479",52573,6,2,-4,959
"2480",52574,6,3,-3,959
"2481",52575,2,3,1,959
"2482",52576,3,4,1,959
"2483",52577,8,9,1,959
"2484",52578,17,18,1,959
"2485",52579,17,19,2,959
"2486",52580,72,71,-1,959
"2487",52581,73,71,-2,959
"2488",52582,65,67,2,959
"2489",52583,94,93,-1,959
"2490",52584,101,98,-3,959
"2491",52585,103,99,-4,959
"2492",52586,103,103,0,959
"2493",52587,103,104,1,959
"2494",52588,102,103,1,959
"2495",52589,74,73,-1,959
"2496",52590,14,10,-4,959
"2497",52591,8,4,-4,959
"2498",52592,8,3,-5,959
"2499",52593,8,3,-5,959
"2500",52594,8,3,-5,959
"2501",52595,7,4,-3,959
"2502",52596,7,4,-3,959
"2503",52597,8,4,-4,959
"2504",52598,8,4,-4,959
"2505",52599,8,3,-5,959
"2506",52600,8,3,-5,959
"2507",52601,9,3,-6,959
"2508",52602,9,3,-6,959
"2509",52603,7,6,-1,959
"2510",52604,7,6,-1,959
"2511",52605,7,6,-1,959
"2512",52606,7,7,0,959
"2513",52607,7,7,0,959
"2514",52608,7,7,0,959
"2515",52609,7,8,1,959
"2516",52610,7,8,1,959
"2517",52611,6,8,2,959
"2518",52612,6,8,2,959
"2519",52613,6,8,2,959
"2520",52614,5,8,3,959
"2521",52615,5,8,3,959
"2522",52616,5,8,3,959
"2523",52617,5,8,3,959
"2524",52618,6,9,3,959
"2525",52643,7,10,3,959
"2526",53259,2,5,3,959
"2527",53260,2,5,3,959
"2528",53261,3,7,4,959
"2529",53262,23,27,4,959
"2530",53263,23,27,4,959
"2531",53264,18,25,7,959
"2532",53265,18,21,3,959
"2533",53266,23,26,3,959
"2534",53267,23,26,3,959
"2535",53268,2,5,3,959
"2536",53269,1,5,4,959
"2537",53270,1,5,4,959
"2538",53271,1,5,4,959
"2539",53272,1,5,4,959
"2540",53273,2,4,2,959
"2541",53274,2,4,2,959
"2542",53275,3,3,0,959
"2543",53276,3,3,0,959
"2544",53277,2,2,0,959
"2545",53278,2,2,0,959
"2546",53279,2,3,1,959
"2547",53280,4,4,0,959
"2548",53281,22,22,0,959
"2549",53282,22,24,2,959
"2550",53283,3,1,-2,959
"2551",53284,3,1,-2,959
"2552",53285,2,1,-1,959
"2553",53286,2,1,-1,959
"2554",53287,2,2,0,959
"2555",53288,2,2,0,959
"2556",53289,5,2,-3,959
"2557",53290,5,2,-3,959
"2558",53291,7,3,-4,959
"2559",53292,13,8,-5,959
"2560",53293,60,59,-1,959
"2561",53294,60,59,-1,959
"2562",53295,34,31,-3,959
"2563",53296,66,63,-3,959
"2564",53297,66,63,-3,959
"2565",53298,94,90,-4,959
"2566",53299,95,93,-2,959
"2567",53300,95,93,-2,959
"2568",53301,94,91,-3,959
"2569",53302,96,93,-3,959
"2570",53303,97,93,-4,959
"2571",53304,95,90,-5,959
"2572",53305,26,22,-4,959
"2573",53306,24,20,-4,959
"2574",53307,9,4,-5,959
"2575",53308,8,3,-5,959
"2576",53309,8,3,-5,959
"2577",53310,8,3,-5,959
"2578",53311,8,3,-5,959
"2579",53312,8,3,-5,959
"2580",53313,8,3,-5,959
"2581",53314,8,3,-5,959
"2582",53315,8,3,-5,959
"2583",53316,8,3,-5,959
"2584",53317,7,4,-3,959
"2585",53318,7,4,-3,959
"2586",53319,6,6,0,959
"2587",53320,6,6,0,959
"2588",53321,7,6,-1,959
"2589",53322,7,6,-1,959
"2590",53323,7,6,-1,959
"2591",53324,7,6,-1,959
"2592",53325,7,6,-1,959
"2593",53326,7,6,-1,959
"2594",53327,6,8,2,959
"2595",53328,6,8,2,959
"2596",53329,6,8,2,959
"2597",53330,6,8,2,959
"2598",53331,6,8,2,959
"2599",53332,5,7,2,959
"2600",53333,5,7,2,959
"2601",53334,5,8,3,959
"2602",53335,5,8,3,959
"2603",53336,5,8,3,959
"2604",53978,2,5,3,959
"2605",53979,2,5,3,959
"2606",53980,2,5,3,959
"2607",53981,3,6,3,959
"2608",53982,12,15,3,959
"2609",53983,12,15,3,959
"2610",53984,5,8,3,959
"2611",53985,23,27,4,959
"2612",53986,23,26,3,959
"2613",53987,22,26,4,959
"2614",53988,21,25,4,959
"2615",53989,21,25,4,959
"2616",53990,16,20,4,959
"2617",53991,13,16,3,959
"2618",53992,5,6,1,959
"2619",53993,1,3,2,959
"2620",53994,1,3,2,959
"2621",53995,1,3,2,959
"2622",53996,2,3,1,959
"2623",53997,1,3,2,959
"2624",53998,2,3,1,959
"2625",53999,3,5,2,959
"2626",54000,12,16,4,959
"2627",54001,10,11,1,959
"2628",54002,6,7,1,959
"2629",54003,3,1,-2,959
"2630",54004,3,1,-2,959
"2631",54005,2,1,-1,959
"2632",54006,3,2,-1,959
"2633",54007,29,28,-1,959
"2634",54008,28,28,0,959
"2635",54009,32,29,-3,959
"2636",54010,34,31,-3,959
"2637",54011,88,88,0,959
"2638",54012,88,87,-1,959
"2639",54013,90,88,-2,959
"2640",54014,89,87,-2,959
"2641",54015,90,88,-2,959
"2642",54016,90,88,-2,959
"2643",54017,79,78,-1,959
"2644",54018,83,80,-3,959
"2645",54019,81,77,-4,959
"2646",54020,72,68,-4,959
"2647",54021,68,66,-2,959
"2648",54022,38,35,-3,959
"2649",54023,9,6,-3,959
"2650",54024,8,4,-4,959
"2651",54025,8,4,-4,959
"2652",54026,8,4,-4,959
"2653",54027,8,4,-4,959
"2654",54028,8,4,-4,959
"2655",54029,8,4,-4,959
"2656",54030,8,4,-4,959
"2657",54031,8,4,-4,959
"2658",54032,8,4,-4,959
"2659",54033,8,4,-4,959
"2660",54034,8,4,-4,959
"2661",54035,7,4,-3,959
"2662",54036,6,4,-2,959
"2663",54037,7,5,-2,959
"2664",54038,7,5,-2,959
"2665",54039,6,6,0,959
"2666",54040,6,6,0,959
"2667",54041,6,5,-1,959
"2668",54042,7,6,-1,959
"2669",54043,6,6,0,959
"2670",54044,6,7,1,959
"2671",54045,6,6,0,959
"2672",54046,6,6,0,959
"2673",54047,6,7,1,959
"2674",54048,6,7,1,959
"2675",54049,5,7,2,959
"2676",54050,5,7,2,959
"2677",54051,5,7,2,959
"2678",54052,5,7,2,959
"2679",54697,2,5,3,959
"2680",54698,2,5,3,959
"2681",54699,2,5,3,959
"2682",54700,2,5,3,959
"2683",54701,2,5,3,959
"2684",54702,2,5,3,959
"2685",54703,1,5,4,959
"2686",54704,2,5,3,959
"2687",54705,3,5,2,959
"2688",54706,4,8,4,959
"2689",54707,23,26,3,959
"2690",54708,22,25,3,959
"2691",54709,18,23,5,959
"2692",54710,15,19,4,959
"2693",54711,19,26,7,959
"2694",54712,21,27,6,959
"2695",54713,21,26,5,959
"2696",54714,22,26,4,959
"2697",54715,22,26,4,959
"2698",54716,22,26,4,959
"2699",54717,23,27,4,959
"2700",54718,23,27,4,959
"2701",54719,24,27,3,959
"2702",54720,13,17,4,959
"2703",54721,18,18,0,959
"2704",54722,32,30,-2,959
"2705",54723,31,28,-3,959
"2706",54724,31,28,-3,959
"2707",54725,43,41,-2,959
"2708",54726,45,42,-3,959
"2709",54727,63,42,-21,959
"2710",54728,66,44,-22,959
"2711",54729,73,43,-30,959
"2712",54730,76,47,-29,959
"2713",54731,88,87,-1,959
"2714",54732,89,86,-3,959
"2715",54733,81,79,-2,959
"2716",54734,83,81,-2,959
"2717",54735,83,82,-1,959
"2718",54736,69,68,-1,959
"2719",54737,69,69,0,959
"2720",54738,7,4,-3,959
"2721",54739,3,4,1,959
"2722",54740,3,4,1,959
"2723",54741,3,4,1,959
"2724",54742,3,3,0,959
"2725",54743,9,4,-5,959
"2726",54744,9,4,-5,959
"2727",54745,8,4,-4,959
"2728",54746,8,4,-4,959
"2729",54747,8,3,-5,959
"2730",54748,8,3,-5,959
"2731",54749,8,4,-4,959
"2732",54750,8,4,-4,959
"2733",54751,7,7,0,959
"2734",54752,7,7,0,959
"2735",54753,7,7,0,959
"2736",54754,7,6,-1,959
"2737",54755,6,6,0,959
"2738",54756,6,6,0,959
"2739",54757,6,6,0,959
"2740",54758,6,6,0,959
"2741",54759,6,6,0,959
"2742",54760,6,7,1,959
"2743",54761,6,8,2,959
"2744",54762,7,8,1,959
"2745",54763,7,8,1,959
"2746",54764,7,8,1,959
"2747",54765,7,8,1,959
"2748",54766,7,8,1,959
"2749",54767,6,8,2,959
"2750",54768,6,8,2,959
"2751",55416,3,7,4,959
"2752",55417,3,7,4,959
"2753",55418,3,7,4,959
"2754",55419,3,6,3,959
"2755",55420,3,6,3,959
"2756",55421,1,4,3,959
"2757",55422,1,4,3,959
"2758",55423,1,3,2,959
"2759",55424,1,3,2,959
"2760",55425,2,3,1,959
"2761",55426,2,3,1,959
"2762",55427,2,4,2,959
"2763",55428,2,4,2,959
"2764",55429,2,4,2,959
"2765",55430,6,8,2,959
"2766",55431,19,25,6,959
"2767",55432,22,27,5,959
"2768",55433,22,27,5,959
"2769",55434,22,26,4,959
"2770",55435,22,26,4,959
"2771",55436,22,26,4,959
"2772",55437,23,27,4,959
"2773",55438,23,27,4,959
"2774",55439,23,27,4,959
"2775",55440,11,15,4,959
"2776",55441,21,22,1,959
"2777",55442,28,28,0,959
"2778",55443,33,29,-4,959
"2779",55444,33,30,-3,959
"2780",55445,11,10,-1,959
"2781",55446,11,5,-6,959
"2782",55447,15,6,-9,959
"2783",55448,15,6,-9,959
"2784",55449,9,5,-4,959
"2785",55450,8,4,-4,959
"2786",55451,3,3,0,959
"2787",55452,3,3,0,959
"2788",55453,7,3,-4,959
"2789",55454,7,3,-4,959
"2790",55455,7,3,-4,959
"2791",55456,7,3,-4,959
"2792",55457,7,4,-3,959
"2793",55458,7,4,-3,959
"2794",55459,3,4,1,959
"2795",55460,3,4,1,959
"2796",55461,3,4,1,959
"2797",55462,3,3,0,959
"2798",55463,9,4,-5,959
"2799",55464,8,4,-4,959
"2800",55465,8,4,-4,959
"2801",55466,8,4,-4,959
"2802",55467,8,3,-5,959
"2803",55468,8,2,-6,959
"2804",55469,8,4,-4,959
"2805",55470,8,4,-4,959
"2806",55471,7,6,-1,959
"2807",55472,7,6,-1,959
"2808",55473,6,6,0,959
"2809",55474,6,6,0,959
"2810",55475,6,6,0,959
"2811",55476,6,6,0,959
"2812",55477,6,6,0,959
"2813",55478,6,6,0,959
"2814",55479,6,7,1,959
"2815",55480,6,7,1,959
"2816",55481,6,8,2,959
"2817",55482,6,8,2,959
"2818",55483,6,8,2,959
"2819",55484,6,8,2,959
"2820",56136,2,7,5,959
"2821",56137,3,7,4,959
"2822",56138,3,7,4,959
"2823",56139,3,6,3,959
"2824",56140,3,6,3,959
"2825",56141,1,4,3,959
"2826",56142,1,4,3,959
"2827",56143,1,3,2,959
"2828",56144,1,3,2,959
"2829",56145,2,3,1,959
"2830",56146,2,3,1,959
"2831",56147,2,4,2,959
"2832",56148,2,4,2,959
"2833",56149,2,4,2,959
"2834",56150,2,4,2,959
"2835",56151,2,4,2,959
"2836",56152,2,4,2,959
"2837",56153,2,4,2,959
"2838",56154,2,4,2,959
"2839",56155,2,4,2,959
"2840",56156,2,4,2,959
"2841",56157,12,14,2,959
"2842",56158,23,27,4,959
"2843",56159,22,26,4,959
"2844",56160,12,16,4,959
"2845",56161,3,2,-1,959
"2846",56162,3,2,-1,959
"2847",56163,6,3,-3,959
"2848",56164,6,3,-3,959
"2849",56165,5,3,-2,959
"2850",56166,5,3,-2,959
"2851",56167,7,3,-4,959
"2852",56168,7,3,-4,959
"2853",56169,7,3,-4,959
"2854",56170,7,3,-4,959
"2855",56171,8,3,-5,959
"2856",56172,8,3,-5,959
"2857",56173,8,3,-5,959
"2858",56174,8,3,-5,959
"2859",56175,8,3,-5,959
"2860",56176,8,3,-5,959
"2861",56177,8,4,-4,959
"2862",56178,8,4,-4,959
"2863",56179,8,4,-4,959
"2864",56180,8,4,-4,959
"2865",56181,7,4,-3,959
"2866",56182,7,4,-3,959
"2867",56183,7,4,-3,959
"2868",56184,7,4,-3,959
"2869",56185,6,6,0,959
"2870",56186,6,5,-1,959
"2871",56187,6,6,0,959
"2872",56188,6,6,0,959
"2873",56189,6,6,0,959
"2874",56190,6,6,0,959
"2875",56191,6,6,0,959
"2876",56192,6,6,0,959
"2877",56193,6,6,0,959
"2878",56194,6,6,0,959
"2879",56195,6,6,0,959
"2880",56196,6,6,0,959
"2881",56197,6,8,2,959
"2882",56857,2,6,4,959
"2883",56858,3,6,3,959
"2884",56859,3,3,0,959
"2885",56860,3,3,0,959
"2886",56861,2,3,1,959
"2887",56862,1,3,2,959
"2888",56863,1,3,2,959
"2889",56864,1,3,2,959
"2890",56865,1,3,2,959
"2891",56866,2,3,1,959
"2892",56867,2,3,1,959
"2893",56868,2,3,1,959
"2894",56869,2,3,1,959
"2895",56870,2,3,1,959
"2896",56871,2,3,1,959
"2897",56872,2,3,1,959
"2898",56873,2,3,1,959
"2899",56874,2,4,2,959
"2900",56875,2,4,2,959
"2901",56876,2,4,2,959
"2902",56877,2,4,2,959
"2903",56878,2,4,2,959
"2904",56879,3,4,1,959
"2905",56880,3,3,0,959
"2906",56881,3,2,-1,959
"2907",56882,3,2,-1,959
"2908",56883,6,3,-3,959
"2909",56884,6,3,-3,959
"2910",56885,5,3,-2,959
"2911",56886,6,3,-3,959
"2912",56887,6,3,-3,959
"2913",56888,6,3,-3,959
"2914",56889,6,3,-3,959
"2915",56890,6,3,-3,959
"2916",56891,7,3,-4,959
"2917",56892,8,3,-5,959
"2918",56893,8,3,-5,959
"2919",56894,8,3,-5,959
"2920",56895,7,3,-4,959
"2921",56896,7,3,-4,959
"2922",56897,7,4,-3,959
"2923",56898,7,4,-3,959
"2924",56899,7,4,-3,959
"2925",56900,7,4,-3,959
"2926",56901,7,4,-3,959
"2927",56902,7,4,-3,959
"2928",56903,7,5,-2,959
"2929",56904,7,5,-2,959
"2930",56905,6,5,-1,959
"2931",56906,6,5,-1,959
"2932",56907,6,6,0,959
"2933",56908,6,6,0,959
"2934",56909,6,6,0,959
"2935",56910,6,6,0,959
"2936",56911,6,6,0,959
"2937",56912,6,6,0,959
"2938",57578,2,4,2,959
"2939",57579,3,3,0,959
"2940",57580,3,3,0,959
"2941",57581,2,3,1,959
"2942",57582,2,3,1,959
"2943",57583,1,3,2,959
"2944",57584,1,3,2,959
"2945",57585,1,3,2,959
"2946",57586,1,3,2,959
"2947",57587,1,3,2,959
"2948",57588,1,3,2,959
"2949",57589,1,3,2,959
"2950",57590,1,3,2,959
"2951",57591,1,3,2,959
"2952",57592,2,3,1,959
"2953",57593,2,3,1,959
"2954",57594,2,3,1,959
"2955",57595,2,3,1,959
"2956",57596,2,3,1,959
"2957",57597,2,4,2,959
"2958",57598,2,4,2,959
"2959",57599,2,4,2,959
"2960",57600,3,3,0,959
"2961",57601,4,3,-1,959
"2962",57602,5,3,-2,959
"2963",57603,5,3,-2,959
"2964",57604,5,3,-2,959
"2965",57605,6,3,-3,959
"2966",57606,6,3,-3,959
"2967",57607,6,4,-2,959
"2968",57608,6,4,-2,959
"2969",57609,7,4,-3,959
"2970",57610,7,4,-3,959
"2971",57611,7,3,-4,959
"2972",57612,7,3,-4,959
"2973",57613,7,3,-4,959
"2974",57614,7,3,-4,959
"2975",57615,7,4,-3,959
"2976",57616,7,4,-3,959
"2977",57617,7,5,-2,959
"2978",57618,7,6,-1,959
"2979",57619,6,6,0,959
"2980",57620,6,6,0,959
"2981",57621,6,6,0,959
"2982",57622,6,6,0,959
"2983",57623,6,6,0,959
"2984",57624,6,6,0,959
"2985",57625,7,6,-1,959
"2986",57626,7,6,-1,959
"2987",57627,7,6,-1,959
"2988",57628,7,6,-1,959
"2989",58300,2,3,1,959
"2990",58301,2,3,1,959
"2991",58302,2,3,1,959
"2992",58303,1,3,2,959
"2993",58304,1,3,2,959
"2994",58305,1,3,2,959
"2995",58306,1,3,2,959
"2996",58307,2,3,1,959
"2997",58308,2,3,1,959
"2998",58309,2,3,1,959
"2999",58310,2,3,1,959
"3000",58311,2,3,1,959
"3001",58312,2,3,1,959
"3002",58313,2,3,1,959
"3003",58314,2,3,1,959
"3004",58315,2,3,1,959
"3005",58316,2,3,1,959
"3006",58317,4,3,-1,959
"3007",58318,4,3,-1,959
"3008",58319,3,3,0,959
"3009",58320,3,3,0,959
"3010",58321,4,3,-1,959
"3011",58322,4,3,-1,959
"3012",58323,4,3,-1,959
"3013",58324,5,3,-2,959
"3014",58325,6,3,-3,959
"3015",58326,6,3,-3,959
"3016",58327,6,4,-2,959
"3017",58328,6,4,-2,959
"3018",58329,7,4,-3,959
"3019",58330,7,4,-3,959
"3020",58331,7,3,-4,959
"3021",58332,7,3,-4,959
"3022",58333,7,3,-4,959
"3023",58334,7,3,-4,959
"3024",58335,7,4,-3,959
"3025",58336,7,4,-3,959
"3026",58337,7,5,-2,959
"3027",58338,7,5,-2,959
"3028",58339,6,5,-1,959
"3029",58340,6,5,-1,959
"3030",58341,6,6,0,959
"3031",58342,6,6,0,959
"3032",58343,7,6,-1,959
"3033",58344,7,6,-1,959
"3034",59022,2,3,1,959
"3035",59023,1,3,2,959
"3036",59024,1,3,2,959
"3037",59025,1,3,2,959
"3038",59026,1,3,2,959
"3039",59027,2,3,1,959
"3040",59028,2,3,1,959
"3041",59029,2,3,1,959
"3042",59030,2,3,1,959
"3043",59031,2,3,1,959
"3044",59032,2,3,1,959
"3045",59033,2,3,1,959
"3046",59034,2,3,1,959
"3047",59035,2,3,1,959
"3048",59036,2,3,1,959
"3049",59037,3,3,0,959
"3050",59038,3,3,0,959
"3051",59039,3,3,0,959
"3052",59040,3,3,0,959
"3053",59041,4,6,2,959
"3054",59042,5,6,1,959
"3055",59043,5,5,0,959
"3056",59044,5,5,0,959
"3057",59045,6,5,-1,959
"3058",59046,6,5,-1,959
"3059",59047,6,5,-1,959
"3060",59048,6,5,-1,959
"3061",59049,7,5,-2,959
"3062",59050,7,5,-2,959
"3063",59051,6,5,-1,959
"3064",59052,6,5,-1,959
"3065",59053,6,5,-1,959
"3066",59054,6,5,-1,959
"3067",59055,6,6,0,959
"3068",59056,6,6,0,959
"3069",59057,6,6,0,959
"3070",59058,7,6,-1,959
"3071",59059,7,6,-1,959
"3072",59750,2,3,1,959
"3073",59751,2,4,2,959
"3074",59752,2,4,2,959
"3075",59753,2,5,3,959
"3076",59754,2,5,3,959
"3077",59755,2,6,4,959
"3078",59756,3,6,3,959
"3079",59757,3,6,3,959
"3080",59758,3,6,3,959
"3081",59759,3,6,3,959
"3082",59760,3,6,3,959
"3083",59761,4,6,2,959
"3084",59762,5,6,1,959
"3085",59763,5,5,0,959
"3086",59764,5,5,0,959
"3087",59765,6,5,-1,959
"3088",59766,6,5,-1,959
"3089",59767,6,5,-1,959
"3090",59768,6,5,-1,959
"3091",59769,7,5,-2,959
"3092",59770,7,5,-2,959
"3093",59771,6,5,-1,959
"3094",60474,2,5,3,959
"3095",60475,2,6,4,959
"3096",60476,2,6,4,959
"3097",60477,3,6,3,959
"3098",60478,3,6,3,959
"3099",60479,3,6,3,959
"3100",60480,3,6,3,959
"3101",60481,5,5,0,959
"3102",60482,5,5,0,959
"3103",60483,5,5,0,959
"3104",60484,5,5,0,959
"3105",60485,5,5,0,959
"3106",61200,4,5,1,959
"3107",49060,60,62,2,925
"3108",49061,14,25,11,925
"3109",49780,108,111,3,925
"3110",49781,104,108,4,925
"3111",50494,115,116,1,925
"3112",50494,115,116,1,925
"3113",50495,114,116,2,925
"3114",50496,115,115,0,925
"3115",50497,115,115,0,925
"3116",50497,115,115,0,925
"3117",50498,115,115,0,925
"3118",50498,115,115,0,925
"3119",50499,112,113,1,925
"3120",50499,112,113,1,925
"3121",50500,112,113,1,925
"3122",50501,59,74,15,925
"3123",51209,11,11,0,925
"3124",51210,11,11,0,925
"3125",51211,12,11,-1,925
"3126",51212,21,20,-1,925
"3127",51213,83,85,2,925
"3128",51214,115,117,2,925
"3129",51214,115,117,2,925
"3130",51215,114,116,2,925
"3131",51215,114,116,2,925
"3132",51216,114,116,2,925
"3133",51216,114,116,2,925
"3134",51217,115,116,1,925
"3135",51217,115,116,1,925
"3136",51218,114,116,2,925
"3137",51219,112,114,2,925
"3138",51220,112,113,1,925
"3139",51221,102,103,1,925
"3140",51923,7,10,3,925
"3141",51924,7,10,3,925
"3142",51925,8,10,2,925
"3143",51926,9,11,2,925
"3144",51927,13,14,1,925
"3145",51928,14,14,0,925
"3146",51929,15,15,0,925
"3147",51930,11,11,0,925
"3148",51931,12,11,-1,925
"3149",51932,13,12,-1,925
"3150",51933,48,52,4,925
"3151",51934,112,115,3,925
"3152",51935,109,111,2,925
"3153",51936,108,110,2,925
"3154",51937,110,112,2,925
"3155",51938,110,110,0,925
"3156",51939,113,113,0,925
"3157",51940,112,114,2,925
"3158",51941,102,107,5,925
"3159",51942,112,112,0,925
"3160",51943,112,112,0,925
"3161",51944,37,46,9,925
"3162",52643,7,10,3,925
"3163",52644,8,11,3,925
"3164",52645,8,11,3,925
"3165",52646,9,11,2,925
"3166",52647,10,11,1,925
"3167",52648,13,14,1,925
"3168",52649,15,15,0,925
"3169",52650,15,15,0,925
"3170",52651,13,13,0,925
"3171",52652,14,13,-1,925
"3172",52653,14,13,-1,925
"3173",52654,74,78,4,925
"3174",52655,114,116,2,925
"3175",52656,113,115,2,925
"3176",52657,113,116,3,925
"3177",52658,109,109,0,925
"3178",52659,114,114,0,925
"3179",52660,115,115,0,925
"3180",52661,115,116,1,925
"3181",52662,115,115,0,925
"3182",52663,71,72,1,925
"3183",52664,64,65,1,925
"3184",53363,7,12,5,925
"3185",53364,7,12,5,925
"3186",53365,7,11,4,925
"3187",53366,9,11,2,925
"3188",53367,10,11,1,925
"3189",53368,10,11,1,925
"3190",53369,10,11,1,925
"3191",53370,11,11,0,925
"3192",53371,11,11,0,925
"3193",53372,12,11,-1,925
"3194",53373,12,11,-1,925
"3195",53374,13,12,-1,925
"3196",53375,21,20,-1,925
"3197",53376,112,115,3,925
"3198",53377,115,118,3,925
"3199",53378,115,116,1,925
"3200",53379,108,109,1,925
"3201",53380,100,103,3,925
"3202",53381,115,116,1,925
"3203",53382,116,117,1,925
"3204",53383,112,113,1,925
"3205",53384,112,113,1,925
"3206",53385,40,47,7,925
"3207",53386,38,46,8,925
"3208",54084,7,12,5,925
"3209",54085,7,11,4,925
"3210",54086,9,11,2,925
"3211",54087,10,11,1,925
"3212",54088,10,11,1,925
"3213",54089,10,11,1,925
"3214",54090,10,11,1,925
"3215",54091,11,11,0,925
"3216",54092,16,15,-1,925
"3217",54093,16,15,-1,925
"3218",54094,12,11,-1,925
"3219",54095,13,12,-1,925
"3220",54096,15,14,-1,925
"3221",54097,115,118,3,925
"3222",54098,116,118,2,925
"3223",54099,115,118,3,925
"3224",54100,93,95,2,925
"3225",54101,100,102,2,925
"3226",54102,115,116,1,925
"3227",54103,115,116,1,925
"3228",54104,113,116,3,925
"3229",54105,113,115,2,925
"3230",54106,68,71,3,925
"3231",54805,9,12,3,925
"3232",54806,9,12,3,925
"3233",54807,11,12,1,925
"3234",54808,11,12,1,925
"3235",54809,11,12,1,925
"3236",54810,11,12,1,925
"3237",54811,11,12,1,925
"3238",54812,12,12,0,925
"3239",54813,13,13,0,925
"3240",54814,13,13,0,925
"3241",54815,13,12,-1,925
"3242",54816,14,13,-1,925
"3243",54817,15,14,-1,925
"3244",54818,117,120,3,925
"3245",54819,118,121,3,925
"3246",54820,90,94,4,925
"3247",54821,104,98,-6,925
"3248",54822,112,113,1,925
"3249",54823,110,112,2,925
"3250",54824,115,116,1,925
"3251",54825,114,116,2,925
"3252",54826,67,71,4,925
"3253",55526,9,12,3,925
"3254",55527,10,12,2,925
"3255",55528,11,12,1,925
"3256",55529,11,12,1,925
"3257",55530,11,12,1,925
"3258",55531,11,12,1,925
"3259",55532,11,12,1,925
"3260",55533,12,12,0,925
"3261",55534,13,12,-1,925
"3262",55535,13,12,-1,925
"3263",55536,13,12,-1,925
"3264",55537,13,12,-1,925
"3265",55538,14,12,-2,925
"3266",55539,15,13,-2,925
"3267",55540,40,39,-1,925
"3268",55541,94,90,-4,925
"3269",55542,109,104,-5,925
"3270",55543,110,103,-7,925
"3271",55544,117,118,1,925
"3272",55545,115,116,1,925
"3273",55546,104,104,0,925
"3274",55547,61,67,6,925
"3275",56247,10,12,2,925
"3276",56248,11,12,1,925
"3277",56249,11,12,1,925
"3278",56250,11,12,1,925
"3279",56251,11,13,2,925
"3280",56252,11,13,2,925
"3281",56253,11,13,2,925
"3282",56254,12,13,1,925
"3283",56255,13,12,-1,925
"3284",56256,13,12,-1,925
"3285",56257,14,13,-1,925
"3286",56258,18,17,-1,925
"3287",56259,18,17,-1,925
"3288",56260,18,17,-1,925
"3289",56261,65,71,6,925
"3290",56262,89,95,6,925
"3291",56263,120,121,1,925
"3292",56264,116,120,4,925
"3293",56265,117,119,2,925
"3294",56266,117,117,0,925
"3295",56267,113,112,-1,925
"3296",56268,112,112,0,925
"3297",56269,51,58,7,925
"3298",56270,51,54,3,925
"3299",56271,50,53,3,925
"3300",56968,10,12,2,925
"3301",56969,11,12,1,925
"3302",56970,11,12,1,925
"3303",56971,11,13,2,925
"3304",56972,11,13,2,925
"3305",56973,11,13,2,925
"3306",56974,11,13,2,925
"3307",56975,12,12,0,925
"3308",56976,13,12,-1,925
"3309",56977,14,13,-1,925
"3310",56978,14,13,-1,925
"3311",56979,16,15,-1,925
"3312",56980,16,15,-1,925
"3313",56981,15,14,-1,925
"3314",56982,16,15,-1,925
"3315",56983,29,27,-2,925
"3316",56984,120,122,2,925
"3317",56985,120,121,1,925
"3318",56986,109,110,1,925
"3319",56988,30,27,-3,925
"3320",56989,110,112,2,925
"3321",56990,118,124,6,925
"3322",56991,118,124,6,925
"3323",56992,20,16,-4,925
"3324",56993,20,16,-4,925
"3325",57690,11,12,1,925
"3326",57691,11,12,1,925
"3327",57692,11,12,1,925
"3328",57693,10,11,1,925
"3329",57694,14,14,0,925
"3330",57695,14,14,0,925
"3331",57696,12,12,0,925
"3332",57697,14,12,-2,925
"3333",57698,13,11,-2,925
"3334",57699,14,12,-2,925
"3335",57700,14,12,-2,925
"3336",57701,14,13,-1,925
"3337",57702,14,14,0,925
"3338",57703,17,16,-1,925
"3339",57704,19,19,0,925
"3340",57705,109,112,3,925
"3341",57706,120,123,3,925
"3342",57707,114,118,4,925
"3343",57708,52,51,-1,925
"3344",57710,118,120,2,925
"3345",57711,121,124,3,925
"3346",57712,121,123,2,925
"3347",57713,112,112,0,925
"3348",57714,53,54,1,925
"3349",58411,11,12,1,925
"3350",58412,11,12,1,925
"3351",58413,10,11,1,925
"3352",58414,10,11,1,925
"3353",58415,10,11,1,925
"3354",58416,10,11,1,925
"3355",58417,11,11,0,925
"3356",58418,13,12,-1,925
"3357",58419,14,12,-2,925
"3358",58420,14,13,-1,925
"3359",58421,12,12,0,925
"3360",58422,12,12,0,925
"3361",58423,13,12,-1,925
"3362",58424,13,12,-1,925
"3363",58425,17,16,-1,925
"3364",58426,92,97,5,925
"3365",58427,120,124,4,925
"3366",58428,118,121,3,925
"3367",58429,116,118,2,925
"3368",58430,59,59,0,925
"3369",58431,119,122,3,925
"3370",58432,122,125,3,925
"3371",58433,124,124,0,925
"3372",58434,122,124,2,925
"3373",58435,94,98,4,925
"3374",59133,13,15,2,925
"3375",59134,13,15,2,925
"3376",59135,9,12,3,925
"3377",59136,9,12,3,925
"3378",59137,9,12,3,925
"3379",59138,12,12,0,925
"3380",59139,13,13,0,925
"3381",59140,14,13,-1,925
"3382",59141,14,13,-1,925
"3383",59142,13,12,-1,925
"3384",59143,14,12,-2,925
"3385",59144,14,12,-2,925
"3386",59145,14,12,-2,925
"3387",59146,18,16,-2,925
"3388",59147,66,67,1,925
"3389",59148,111,113,2,925
"3390",59149,124,124,0,925
"3391",59150,122,124,2,925
"3392",59151,124,126,2,925
"3393",59151,124,126,2,925
"3394",59152,117,121,4,925
"3395",59153,110,112,2,925
"3396",59154,122,122,0,925
"3397",59855,13,14,1,925
"3398",59856,9,11,2,925
"3399",59857,9,11,2,925
"3400",59858,12,12,0,925
"3401",59859,12,12,0,925
"3402",59860,13,13,0,925
"3403",59861,14,13,-1,925
"3404",59862,14,13,-1,925
"3405",59863,15,13,-2,925
"3406",59864,14,12,-2,925
"3407",59865,14,12,-2,925
"3408",59866,14,12,-2,925
"3409",59867,19,17,-2,925
"3410",59868,72,77,5,925
"3411",59868,72,77,5,925
"3412",59869,103,86,-17,925
"3413",59869,103,86,-17,925
"3414",59870,114,114,0,925
"3415",59870,114,114,0,925
"3416",59871,128,129,1,925
"3417",59871,128,129,1,925
"3418",59872,127,128,1,925
"3419",59873,123,124,1,925
"3420",59874,122,123,1,925
"3421",60577,8,11,3,925
"3422",60578,10,12,2,925
"3423",60579,13,13,0,925
"3424",60580,13,13,0,925
"3425",60581,13,13,0,925
"3426",60582,12,12,0,925
"3427",60583,13,12,-1,925
"3428",60584,15,12,-3,925
"3429",60585,15,12,-3,925
"3430",60586,15,12,-3,925
"3431",60586,15,12,-3,925
"3432",60587,15,12,-3,925
"3433",60587,15,12,-3,925
"3434",60588,20,17,-3,925
"3435",60588,20,17,-3,925
"3436",60589,69,74,5,925
"3437",60590,97,100,3,925
"3438",61298,9,11,2,925
"3439",61299,11,12,1,925
"3440",61300,11,12,1,925
"3441",61301,12,12,0,925
"3442",61302,12,12,0,925
"3443",61303,13,12,-1,925
"3444",61304,14,12,-2,925
"3445",61304,14,12,-2,925
"3446",61305,14,12,-2,925
"3447",61305,14,12,-2,925
"3448",61306,15,12,-3,925
"3449",61306,15,12,-3,925
"3450",61307,15,12,-3,925
"3451",61308,17,14,-3,925
"3452",62020,12,10,-2,925
"3453",62021,12,10,-2,925
"3454",62022,13,10,-3,925
"3455",62022,13,10,-3,925
"3456",62023,13,9,-4,925
"3457",62023,13,9,-4,925
"3458",62024,14,9,-5,925
"3459",62024,14,9,-5,925
"3460",62025,15,9,-6,925
"3461",59151,124,126,2,848
"3462",59154,122,122,0,848
"3463",59155,121,121,0,848
"3464",59156,106,106,0,848
"3465",59868,72,77,5,848
"3466",59869,103,86,-17,848
"3467",59870,114,114,0,848
"3468",59871,128,129,1,848
"3469",59872,127,128,1,848
"3470",59873,123,124,1,848
"3471",59874,122,123,1,848
"3472",59875,123,121,-2,848
"3473",59876,120,119,-1,848
"3474",60586,15,12,-3,848
"3475",60587,15,12,-3,848
"3476",60588,20,17,-3,848
"3477",60589,69,74,5,848
"3478",60590,97,100,3,848
"3479",60591,130,131,1,848
"3480",60592,120,119,-1,848
"3481",60595,119,119,0,848
"3482",60596,119,119,0,848
"3483",61304,14,12,-2,848
"3484",61305,14,12,-2,848
"3485",61306,15,12,-3,848
"3486",61307,15,12,-3,848
"3487",61308,17,14,-3,848
"3488",61309,20,20,0,848
"3489",61310,41,39,-2,848
"3490",61311,130,130,0,848
"3491",61312,127,126,-1,848
"3492",61314,0,0,0,848
"3493",61316,0,0,0,848
"3494",62022,13,10,-3,848
"3495",62023,13,9,-4,848
"3496",62024,14,9,-5,848
"3497",62025,15,9,-6,848
"3498",62026,15,9,-6,848
"3499",62027,15,11,-4,848
"3500",62028,15,11,-4,848
"3501",62029,15,14,-1,848
"3502",62030,31,33,2,848
"3503",62031,122,118,-4,848
"3504",62032,133,131,-2,848
"3505",62033,126,126,0,848
"3506",62742,13,10,-3,848
"3507",62743,13,9,-4,848
"3508",62744,13,9,-4,848
"3509",62745,13,9,-4,848
"3510",62746,15,9,-6,848
"3511",62747,14,11,-3,848
"3512",62748,15,11,-4,848
"3513",62749,15,14,-1,848
"3514",62750,19,18,-1,848
"3515",62751,105,85,-20,848
"3516",62752,134,134,0,848
"3517",62753,129,130,1,848
"3518",63463,11,10,-1,848
"3519",63464,11,10,-1,848
"3520",63465,11,10,-1,848
"3521",63466,12,10,-2,848
"3522",63467,14,10,-4,848
"3523",63468,15,10,-5,848
"3524",63469,18,13,-5,848
"3525",63470,28,25,-3,848
"3526",63471,108,105,-3,848
"3527",63472,133,131,-2,848
"3528",63473,126,125,-1,848
"3529",64183,11,10,-1,848
"3530",64184,11,10,-1,848
"3531",64185,12,10,-2,848
"3532",64186,12,10,-2,848
"3533",64187,12,10,-2,848
"3534",64188,15,10,-5,848
"3535",64189,16,12,-4,848
"3536",64190,21,18,-3,848
"3537",64191,75,72,-3,848
"3538",64192,129,126,-3,848
"3539",64193,123,122,-1,848
"3540",64903,11,10,-1,848
"3541",64904,12,10,-2,848
"3542",64905,10,10,0,848
"3543",64906,11,10,-1,848
"3544",64907,12,10,-2,848
"3545",64908,14,10,-4,848
"3546",64909,16,9,-7,848
"3547",64910,39,32,-7,848
"3548",64911,109,105,-4,848
"3549",64912,108,104,-4,848
"3550",65623,12,11,-1,848
"3551",65624,13,10,-3,848
"3552",65625,11,10,-1,848
"3553",65626,13,10,-3,848
"3554",65627,13,10,-3,848
"3555",65628,16,10,-6,848
"3556",65629,17,9,-8,848
"3557",65630,30,24,-6,848
"3558",65631,116,110,-6,848
"3559",65632,111,106,-5,848
"3560",66342,14,10,-4,848
"3561",66343,14,10,-4,848
"3562",66344,15,10,-5,848
"3563",66345,14,9,-5,848
"3564",66346,14,9,-5,848
"3565",66347,14,11,-3,848
"3566",66348,16,11,-5,848
"3567",66349,17,11,-6,848
"3568",66350,23,17,-6,848
"3569",66351,104,93,-11,848
"3570",66352,102,92,-10,848
"3571",67062,13,10,-3,848
"3572",67063,14,10,-4,848
"3573",67064,15,10,-5,848
"3574",67065,15,10,-5,848
"3575",67066,16,10,-6,848
"3576",67067,15,12,-3,848
"3577",67068,15,11,-4,848
"3578",67069,17,11,-6,848
"3579",67070,23,17,-6,848
"3580",67071,114,105,-9,848
"3581",67072,110,104,-6,848
"3582",67782,13,11,-2,848
"3583",67783,14,10,-4,848
"3584",67784,15,11,-4,848
"3585",67785,16,11,-5,848
"3586",67786,16,10,-6,848
"3587",67787,16,10,-6,848
"3588",67788,17,10,-7,848
"3589",67789,16,12,-4,848
"3590",67790,21,17,-4,848
"3591",67791,128,116,-12,848
"3592",67792,125,113,-12,848
"3593",68502,13,11,-2,848
"3594",68503,13,10,-3,848
"3595",68504,14,10,-4,848
"3596",68505,16,10,-6,848
"3597",68506,16,10,-6,848
"3598",68507,16,10,-6,848
"3599",68508,17,10,-7,848
"3600",68509,16,12,-4,848
"3601",68510,21,17,-4,848
"3602",68511,116,101,-15,848
"3603",68512,113,100,-13,848
"3604",69222,13,11,-2,848
"3605",69223,13,11,-2,848
"3606",69224,14,11,-3,848
"3607",69225,15,11,-4,848
"3608",69226,17,12,-5,848
"3609",69227,17,12,-5,848
"3610",69228,17,11,-6,848
"3611",69229,18,12,-6,848
"3612",69230,23,17,-6,848
"3613",69231,87,77,-10,848
"3614",69232,86,77,-9,848
"3615",69943,13,11,-2,848
"3616",69944,14,11,-3,848
"3617",69945,16,12,-4,848
"3618",69946,17,12,-5,848
"3619",69947,16,11,-5,848
"3620",69948,17,11,-6,848
"3621",69949,17,12,-5,848
"3622",69950,18,12,-6,848
"3623",69951,124,112,-12,848
"3624",69952,123,113,-10,848
"3625",70663,13,10,-3,848
"3626",70664,14,11,-3,848
"3627",70665,15,10,-5,848
"3628",70666,15,11,-4,848
"3629",70667,15,11,-4,848
"3630",70668,15,11,-4,848
"3631",70669,17,11,-6,848
"3632",70670,20,14,-6,848
"3633",70671,116,107,-9,848
"3634",70672,115,107,-8,848
"3635",71383,13,10,-3,848
"3636",71384,14,11,-3,848
"3637",71385,17,12,-5,848
"3638",71386,17,13,-4,848
"3639",71387,17,13,-4,848
"3640",71388,16,12,-4,848
"3641",71389,19,13,-6,848
"3642",71390,21,16,-5,848
"3643",71391,110,98,-12,848
"3644",71392,109,99,-10,848
"3645",72103,14,10,-4,848
"3646",72104,15,10,-5,848
"3647",72105,15,10,-5,848
"3648",72106,15,10,-5,848
"3649",72107,15,10,-5,848
"3650",72108,15,10,-5,848
"3651",72109,16,10,-6,848
"3652",72110,21,16,-5,848
"3653",72111,32,24,-8,848
"3654",72112,119,104,-15,848
"3655",72113,118,101,-17,848
"3656",72823,14,10,-4,848
"3657",72824,15,10,-5,848
"3658",72825,15,10,-5,848
"3659",72826,15,10,-5,848
"3660",72827,15,10,-5,848
"3661",72828,16,10,-6,848
"3662",72829,16,10,-6,848
"3663",72830,17,10,-7,848
"3664",72831,19,12,-7,848
"3665",72832,45,34,-11,848
"3666",72833,43,34,-9,848
"3667",73544,14,9,-5,848
"3668",73545,15,9,-6,848
"3669",73546,15,9,-6,848
"3670",73547,16,9,-7,848
"3671",73548,16,9,-7,848
"3672",73549,17,8,-9,848
"3673",73550,17,8,-9,848
"3674",73551,17,8,-9,848
"3675",73552,35,25,-10,848
"3676",73553,134,113,-21,848
"3677",73554,126,107,-19,848
"3678",74264,13,9,-4,848
"3679",74265,15,9,-6,848
"3680",74266,15,9,-6,848
"3681",74267,16,9,-7,848
"3682",74268,16,9,-7,848
"3683",74269,17,8,-9,848
"3684",74270,17,8,-9,848
"3685",74271,17,8,-9,848
"3686",74272,18,9,-9,848
"3687",74273,94,77,-17,848
"3688",74274,141,120,-21,848
"3689",74275,123,105,-18,848
"3690",74276,116,104,-12,848
"3691",74985,15,9,-6,848
"3692",74986,16,9,-7,848
"3693",74987,16,8,-8,848
"3694",74988,16,8,-8,848
"3695",74989,17,8,-9,848
"3696",74990,18,9,-9,848
"3697",74991,18,10,-8,848
"3698",74992,18,10,-8,848
"3699",74993,19,10,-9,848
"3700",74994,131,116,-15,848
"3701",74995,145,129,-16,848
"3702",74996,140,127,-13,848
"3703",75705,14,9,-5,848
"3704",75706,15,9,-6,848
"3705",75707,16,8,-8,848
"3706",75708,16,8,-8,848
"3707",75709,17,9,-8,848
"3708",75710,18,9,-9,848
"3709",75711,18,10,-8,848
"3710",75712,18,10,-8,848
"3711",75713,19,9,-10,848
"3712",75714,31,19,-12,848
"3713",75715,135,120,-15,848
"3714",75716,130,117,-13,848
"3715",76426,14,9,-5,848
"3716",76427,14,9,-5,848
"3717",76428,15,9,-6,848
"3718",76429,15,9,-6,848
"3719",76430,17,9,-8,848
"3720",76431,17,9,-8,848
"3721",76432,17,9,-8,848
"3722",76433,20,9,-11,848
"3723",76434,21,11,-10,848
"3724",76435,47,38,-9,848
"3725",76436,143,127,-16,848
"3726",76437,141,124,-17,848
"3727",77147,14,9,-5,848
"3728",77148,14,9,-5,848
"3729",77149,15,9,-6,848
"3730",77150,15,9,-6,848
"3731",77151,17,9,-8,848
"3732",77152,17,9,-8,848
"3733",77153,20,9,-11,848
"3734",77154,20,9,-11,848
"3735",77155,22,13,-9,848
"3736",77156,96,77,-19,848
"3737",77157,96,76,-20,848
"3738",77867,13,8,-5,848
"3739",77868,14,8,-6,848
"3740",77869,16,9,-7,848
"3741",77870,17,9,-8,848
"3742",77871,19,10,-9,848
"3743",77872,21,10,-11,848
"3744",77873,21,11,-10,848
"3745",77874,21,11,-10,848
"3746",77875,22,15,-7,848
"3747",77876,28,24,-4,848
"3748",77877,69,55,-14,848
"3749",77878,67,54,-13,848
"3750",78588,14,8,-6,848
"3751",78589,17,9,-8,848
"3752",78590,17,9,-8,848
"3753",78591,19,10,-9,848
"3754",78592,21,10,-11,848
"3755",78593,21,11,-10,848
"3756",78594,21,11,-10,848
"3757",78595,21,12,-9,848
"3758",78596,22,14,-8,848
"3759",78597,97,77,-20,848
"3760",78598,123,100,-23,848
"3761",78599,118,95,-23,848
"3762",79309,18,11,-7,848
"3763",79310,19,12,-7,848
"3764",79311,20,12,-8,848
"3765",79312,20,12,-8,848
"3766",79313,21,12,-9,848
"3767",79314,20,12,-8,848
"3768",79315,20,13,-7,848
"3769",79316,20,13,-7,848
"3770",79317,70,60,-10,848
"3771",79318,97,83,-14,848
"3772",79319,94,81,-13,848
"3773",80030,19,12,-7,848
"3774",80031,20,12,-8,848
"3775",80032,20,12,-8,848
"3776",80033,20,12,-8,848
"3777",80034,21,12,-9,848
"3778",80035,21,13,-8,848
"3779",80036,21,13,-8,848
"3780",80037,20,13,-7,848
"3781",80038,42,34,-8,848
"3782",80039,128,109,-19,848
"3783",80040,171,145,-26,848
"3784",80041,173,144,-29,848
"3785",80042,159,157,-2,848
"3786",80043,150,151,1,848
"3787",80751,20,13,-7,848
"3788",80752,20,13,-7,848
"3789",80753,20,13,-7,848
"3790",80754,21,13,-8,848
"3791",80755,21,13,-8,848
"3792",80756,21,13,-8,848
"3793",80757,20,14,-6,848
"3794",80758,22,16,-6,848
"3795",80759,37,33,-4,848
"3796",80760,162,150,-12,848
"3797",80761,171,160,-11,848
"3798",80762,163,148,-15,848
"3799",80763,174,170,-4,848
"3800",80764,172,168,-4,848
"3801",80765,162,156,-6,848
"3802",81472,20,13,-7,848
"3803",81473,21,13,-8,848
"3804",81474,21,14,-7,848
"3805",81475,22,14,-8,848
"3806",81476,22,14,-8,848
"3807",81477,20,14,-6,848
"3808",81478,22,15,-7,848
"3809",81479,29,23,-6,848
"3810",81480,46,42,-4,848
"3811",81481,176,158,-18,848
"3812",81482,175,158,-17,848
"3813",81483,176,169,-7,848
"3814",81484,171,165,-6,848
"3815",81485,169,162,-7,848
"3816",81486,152,149,-3,848
"3817",82192,19,14,-5,848
"3818",82193,19,14,-5,848
"3819",82194,19,14,-5,848
"3820",82195,19,14,-5,848
"3821",82196,20,14,-6,848
"3822",82197,20,17,-3,848
"3823",82198,22,17,-5,848
"3824",82199,23,18,-5,848
"3825",82200,40,38,-2,848
"3826",82201,91,70,-21,848
"3827",82202,153,142,-11,848
"3828",82203,173,167,-6,848
"3829",82204,169,164,-5,848
"3830",82205,90,89,-1,848
"3831",82206,88,89,1,848
"3832",82913,19,14,-5,848
"3833",82914,19,14,-5,848
"3834",82915,19,14,-5,848
"3835",82916,19,14,-5,848
"3836",82917,18,15,-3,848
"3837",82918,20,16,-4,848
"3838",82919,20,16,-4,848
"3839",82920,28,24,-4,848
"3840",82921,60,49,-11,848
"3841",82922,90,73,-17,848
"3842",82923,89,71,-18,848
"3843",82924,65,53,-12,848
"3844",82925,39,43,4,848
"3845",83633,17,13,-4,848
"3846",83634,17,13,-4,848
"3847",83635,17,13,-4,848
"3848",83636,17,14,-3,848
"3849",83637,17,16,-1,848
"3850",83638,18,16,-2,848
"3851",83639,19,16,-3,848
"3852",83640,19,16,-3,848
"3853",83641,18,21,3,848
"3854",83642,23,26,3,848
"3855",83643,24,28,4,848
"3856",83644,24,27,3,848
"3857",84354,17,14,-3,848
"3858",84355,17,14,-3,848
"3859",84356,18,14,-4,848
"3860",84357,18,16,-2,848
"3861",84358,18,16,-2,848
"3862",84359,17,15,-2,848
"3863",84360,18,15,-3,848
"3864",84361,15,18,3,848
"3865",84362,24,28,4,848
"3866",84363,27,33,6,848
"3867",84364,28,33,5,848
"3868",85076,15,13,-2,848
"3869",85077,15,13,-2,848
"3870",85078,16,13,-3,848
"3871",85079,13,15,2,848
"3872",85080,13,15,2,848
"3873",85081,16,17,1,848
"3874",85082,17,19,2,848
