"","INDEX","X2000","X2087","change","EEZID"
"1",82205,83,74,-9,945
"2",82206,80,74,-6,945
"3",82924,60,51,-9,945
"4",82925,35,33,-2,945
"5",82926,149,138,-11,945
"6",82927,141,130,-11,945
"7",83644,23,20,-3,945
"8",83645,25,25,0,945
"9",83646,35,35,0,945
"10",83647,35,33,-2,945
"11",83651,128,121,-7,945
"12",83652,129,121,-8,945
"13",83653,129,121,-8,945
"14",84362,28,21,-7,945
"15",84363,27,20,-7,945
"16",84364,27,20,-7,945
"17",84365,20,20,0,945
"18",84366,21,22,1,945
"19",84367,143,136,-7,945
"20",84368,140,135,-5,945
"21",84371,148,138,-10,945
"22",84372,151,141,-10,945
"23",84373,150,140,-10,945
"24",84374,150,140,-10,945
"25",85077,13,11,-2,945
"26",85078,12,12,0,945
"27",85079,11,12,1,945
"28",85080,12,12,0,945
"29",85081,14,12,-2,945
"30",85082,16,13,-3,945
"31",85083,16,14,-2,945
"32",85084,16,14,-2,945
"33",85085,27,27,0,945
"34",85086,27,28,1,945
"35",85087,31,33,2,945
"36",85088,82,79,-3,945
"37",85091,132,123,-9,945
"38",85092,146,133,-13,945
"39",85093,130,113,-17,945
"40",85094,149,130,-19,945
"41",85095,110,90,-20,945
"42",85796,12,12,0,945
"43",85797,12,11,-1,945
"44",85798,12,12,0,945
"45",85799,11,12,1,945
"46",85800,12,13,1,945
"47",85801,14,13,-1,945
"48",85802,15,13,-2,945
"49",85803,14,12,-2,945
"50",85804,15,13,-2,945
"51",85805,26,26,0,945
"52",85806,26,28,2,945
"53",85807,28,30,2,945
"54",85808,154,155,1,945
"55",85809,155,154,-1,945
"56",85811,149,141,-8,945
"57",85812,162,151,-11,945
"58",85813,115,102,-13,945
"59",85814,142,128,-14,945
"60",85815,133,123,-10,945
"61",86516,12,12,0,945
"62",86517,11,12,1,945
"63",86518,11,12,1,945
"64",86519,12,13,1,945
"65",86520,14,13,-1,945
"66",86521,14,13,-1,945
"67",86522,14,13,-1,945
"68",86523,15,12,-3,945
"69",86524,15,13,-2,945
"70",86525,23,25,2,945
"71",86526,33,35,2,945
"72",86527,39,42,3,945
"73",86528,48,51,3,945
"74",86529,150,146,-4,945
"75",86530,139,134,-5,945
"76",86532,153,140,-13,945
"77",86533,155,141,-14,945
"78",86534,153,140,-13,945
"79",86535,150,140,-10,945
"80",86536,120,114,-6,945
"81",87236,11,12,1,945
"82",87237,11,12,1,945
"83",87238,11,12,1,945
"84",87239,11,13,2,945
"85",87240,13,13,0,945
"86",87241,13,13,0,945
"87",87242,13,13,0,945
"88",87243,16,13,-3,945
"89",87244,21,20,-1,945
"90",87245,23,24,1,945
"91",87246,27,30,3,945
"92",87247,34,37,3,945
"93",87248,37,41,4,945
"94",87249,112,112,0,945
"95",87250,156,154,-2,945
"96",87251,150,147,-3,945
"97",87253,148,139,-9,945
"98",87254,151,139,-12,945
"99",87255,113,100,-13,945
"100",87256,102,93,-9,945
"101",87956,11,11,0,945
"102",87957,12,11,-1,945
"103",87958,12,11,-1,945
"104",87959,13,11,-2,945
"105",87960,14,12,-2,945
"106",87961,15,12,-3,945
"107",87962,15,12,-3,945
"108",87963,21,15,-6,945
"109",87964,21,19,-2,945
"110",87965,22,21,-1,945
"111",87966,22,24,2,945
"112",87967,23,24,1,945
"113",87968,30,31,1,945
"114",87969,79,72,-7,945
"115",87970,115,105,-10,945
"116",87971,140,132,-8,945
"117",87972,136,127,-9,945
"118",87974,143,135,-8,945
"119",87975,147,137,-10,945
"120",87976,142,137,-5,945
"121",87977,127,120,-7,945
"122",88676,10,11,1,945
"123",88677,13,11,-2,945
"124",88678,13,11,-2,945
"125",88679,13,11,-2,945
"126",88680,14,12,-2,945
"127",88681,16,12,-4,945
"128",88682,16,12,-4,945
"129",88683,21,15,-6,945
"130",88684,21,15,-6,945
"131",88685,21,21,0,945
"132",88686,22,21,-1,945
"133",88687,23,24,1,945
"134",88688,23,23,0,945
"135",88689,155,148,-7,945
"136",88690,155,148,-7,945
"137",88691,150,139,-11,945
"138",88692,146,134,-12,945
"139",88695,131,123,-8,945
"140",88696,130,124,-6,945
"141",88697,142,135,-7,945
"142",88698,140,132,-8,945
"143",89397,15,17,2,945
"144",89398,16,17,1,945
"145",89399,19,16,-3,945
"146",89400,20,17,-3,945
"147",89401,21,18,-3,945
"148",89402,21,18,-3,945
"149",89403,21,19,-2,945
"150",89404,21,19,-2,945
"151",89405,21,19,-2,945
"152",89406,21,19,-2,945
"153",89407,22,20,-2,945
"154",89408,23,20,-3,945
"155",89409,75,64,-11,945
"156",89410,149,139,-10,945
"157",89411,144,136,-8,945
"158",89412,130,121,-9,945
"159",89413,77,74,-3,945
"160",89415,135,136,1,945
"161",89416,137,138,1,945
"162",89417,52,43,-9,945
"163",89418,141,137,-4,945
"164",89419,139,136,-3,945
"165",90117,15,17,2,945
"166",90118,16,17,1,945
"167",90119,18,16,-2,945
"168",90120,19,17,-2,945
"169",90121,21,18,-3,945
"170",90122,21,18,-3,945
"171",90123,21,19,-2,945
"172",90124,21,19,-2,945
"173",90125,21,19,-2,945
"174",90126,21,19,-2,945
"175",90127,22,19,-3,945
"176",90128,23,20,-3,945
"177",90129,24,20,-4,945
"178",90130,32,27,-5,945
"179",90131,141,137,-4,945
"180",90132,141,137,-4,945
"181",90136,137,134,-3,945
"182",90137,138,136,-2,945
"183",90138,25,15,-10,945
"184",90139,137,134,-3,945
"185",90140,139,134,-5,945
"186",90141,100,100,0,945
"187",90838,16,18,2,945
"188",90839,19,18,-1,945
"189",90840,19,19,0,945
"190",90841,21,19,-2,945
"191",90842,21,19,-2,945
"192",90843,21,19,-2,945
"193",90844,22,19,-3,945
"194",90845,21,19,-2,945
"195",90846,22,19,-3,945
"196",90847,22,19,-3,945
"197",90848,23,19,-4,945
"198",90849,22,19,-3,945
"199",90850,22,19,-3,945
"200",90851,24,15,-9,945
"201",90852,110,103,-7,945
"202",90853,126,121,-5,945
"203",90854,123,118,-5,945
"204",90855,98,96,-2,945
"205",90857,140,136,-4,945
"206",90858,142,137,-5,945
"207",90859,28,18,-10,945
"208",90860,130,123,-7,945
"209",90861,130,123,-7,945
"210",90862,115,108,-7,945
"211",91559,18,18,0,945
"212",91560,19,19,0,945
"213",91561,20,19,-1,945
"214",91562,21,19,-2,945
"215",91563,21,19,-2,945
"216",91564,22,19,-3,945
"217",91565,21,19,-2,945
"218",91566,22,19,-3,945
"219",91567,22,19,-3,945
"220",91568,22,19,-3,945
"221",91569,23,19,-4,945
"222",91570,25,21,-4,945
"223",91571,24,15,-9,945
"224",91572,23,13,-10,945
"225",91573,110,104,-6,945
"226",91574,110,105,-5,945
"227",91575,119,116,-3,945
"228",91576,107,105,-2,945
"229",91578,97,82,-15,945
"230",91579,97,84,-13,945
"231",91580,33,23,-10,945
"232",91581,127,122,-5,945
"233",91582,122,116,-6,945
"234",92280,18,19,1,945
"235",92281,19,19,0,945
"236",92282,20,19,-1,945
"237",92283,21,19,-2,945
"238",92284,21,19,-2,945
"239",92285,22,19,-3,945
"240",92286,22,19,-3,945
"241",92287,22,19,-3,945
"242",92288,22,19,-3,945
"243",92289,21,18,-3,945
"244",92290,21,18,-3,945
"245",92291,18,12,-6,945
"246",92292,18,12,-6,945
"247",92293,32,24,-8,945
"248",92294,74,70,-4,945
"249",92295,120,118,-2,945
"250",92296,117,114,-3,945
"251",92298,124,122,-2,945
"252",92299,129,127,-2,945
"253",92300,32,29,-3,945
"254",92301,99,95,-4,945
"255",92302,121,119,-2,945
"256",92303,76,75,-1,945
"257",93002,21,21,0,945
"258",93003,21,19,-2,945
"259",93004,21,19,-2,945
"260",93005,22,19,-3,945
"261",93006,22,19,-3,945
"262",93007,22,19,-3,945
"263",93008,22,19,-3,945
"264",93009,21,18,-3,945
"265",93010,21,18,-3,945
"266",93011,17,12,-5,945
"267",93012,17,12,-5,945
"268",93013,23,17,-6,945
"269",93014,67,60,-7,945
"270",93015,106,101,-5,945
"271",93016,104,101,-3,945
"272",93019,79,75,-4,945
"273",93020,80,75,-5,945
"274",93021,20,17,-3,945
"275",93022,124,120,-4,945
"276",93023,121,118,-3,945
"277",93024,114,113,-1,945
"278",93722,19,19,0,945
"279",93723,19,19,0,945
"280",93724,21,19,-2,945
"281",93725,21,19,-2,945
"282",93726,20,19,-1,945
"283",93727,20,18,-2,945
"284",93728,20,18,-2,945
"285",93729,21,19,-2,945
"286",93730,21,19,-2,945
"287",93731,21,12,-9,945
"288",93732,22,12,-10,945
"289",93733,22,18,-4,945
"290",93734,26,21,-5,945
"291",93735,80,75,-5,945
"292",93736,118,116,-2,945
"293",93737,115,114,-1,945
"294",93739,115,115,0,945
"295",93740,118,116,-2,945
"296",93741,40,34,-6,945
"297",93742,26,22,-4,945
"298",93743,84,79,-5,945
"299",93744,123,118,-5,945
"300",93745,106,105,-1,945
"301",94442,18,19,1,945
"302",94443,19,19,0,945
"303",94444,21,19,-2,945
"304",94445,20,19,-1,945
"305",94446,20,19,-1,945
"306",94447,19,18,-1,945
"307",94448,20,18,-2,945
"308",94449,21,19,-2,945
"309",94450,21,19,-2,945
"310",94451,21,12,-9,945
"311",94452,22,12,-10,945
"312",94453,22,19,-3,945
"313",94454,22,20,-2,945
"314",94455,27,27,0,945
"315",94456,79,75,-4,945
"316",94457,115,114,-1,945
"317",94458,115,113,-2,945
"318",94459,113,111,-2,945
"319",94460,113,115,2,945
"320",94461,113,112,-1,945
"321",94462,42,38,-4,945
"322",94463,26,21,-5,945
"323",94464,101,97,-4,945
"324",94465,113,112,-1,945
"325",94466,106,105,-1,945
"326",95162,18,19,1,945
"327",95163,18,19,1,945
"328",95164,18,19,1,945
"329",95165,19,18,-1,945
"330",95166,19,18,-1,945
"331",95167,20,19,-1,945
"332",95168,20,19,-1,945
"333",95169,21,19,-2,945
"334",95170,21,19,-2,945
"335",95171,21,12,-9,945
"336",95172,21,12,-9,945
"337",95173,21,18,-3,945
"338",95174,22,18,-4,945
"339",95175,23,21,-2,945
"340",95176,60,54,-6,945
"341",95177,68,64,-4,945
"342",95178,70,61,-9,945
"343",95179,111,108,-3,945
"344",95180,106,106,0,945
"345",95181,111,114,3,945
"346",95182,110,110,0,945
"347",95183,22,19,-3,945
"348",95184,29,26,-3,945
"349",95185,85,83,-2,945
"350",95186,113,111,-2,945
"351",95187,102,102,0,945
"352",95882,18,19,1,945
"353",95883,18,19,1,945
"354",95884,18,19,1,945
"355",95885,19,18,-1,945
"356",95886,19,18,-1,945
"357",95887,20,19,-1,945
"358",95888,20,19,-1,945
"359",95889,20,19,-1,945
"360",95890,21,19,-2,945
"361",95891,21,12,-9,945
"362",95892,21,12,-9,945
"363",95893,21,18,-3,945
"364",95894,22,19,-3,945
"365",95895,22,20,-2,945
"366",95896,22,20,-2,945
"367",95897,34,30,-4,945
"368",95898,36,33,-3,945
"369",95899,66,56,-10,945
"370",95900,108,106,-2,945
"371",95901,106,103,-3,945
"372",95902,108,105,-3,945
"373",95903,23,18,-5,945
"374",95904,22,17,-5,945
"375",95905,22,20,-2,945
"376",95906,64,57,-7,945
"377",95907,113,105,-8,945
"378",95908,106,101,-5,945
"379",96603,16,19,3,945
"380",96604,19,19,0,945
"381",96605,20,19,-1,945
"382",96606,20,19,-1,945
"383",96607,20,19,-1,945
"384",96608,20,19,-1,945
"385",96609,19,12,-7,945
"386",96610,20,12,-8,945
"387",96611,21,12,-9,945
"388",96612,21,12,-9,945
"389",96613,21,19,-2,945
"390",96614,22,19,-3,945
"391",96615,22,19,-3,945
"392",96616,22,19,-3,945
"393",96617,20,17,-3,945
"394",96618,20,17,-3,945
"395",96619,24,20,-4,945
"396",96620,106,102,-4,945
"397",96621,106,102,-4,945
"398",96622,37,34,-3,945
"399",96623,20,18,-2,945
"400",96624,20,18,-2,945
"401",96625,24,22,-2,945
"402",96626,24,22,-2,945
"403",96627,62,55,-7,945
"404",96628,107,104,-3,945
"405",96629,99,96,-3,945
"406",97324,16,18,2,945
"407",97325,17,18,1,945
"408",97326,19,18,-1,945
"409",97327,20,19,-1,945
"410",97328,20,19,-1,945
"411",97329,20,12,-8,945
"412",97330,21,12,-9,945
"413",97331,21,12,-9,945
"414",97332,21,12,-9,945
"415",97333,21,19,-2,945
"416",97334,22,19,-3,945
"417",97335,23,19,-4,945
"418",97336,22,19,-3,945
"419",97337,20,17,-3,945
"420",97338,20,17,-3,945
"421",97339,20,18,-2,945
"422",97340,20,18,-2,945
"423",97341,21,18,-3,945
"424",97342,21,18,-3,945
"425",97343,20,18,-2,945
"426",97344,20,18,-2,945
"427",97345,20,18,-2,945
"428",97346,20,18,-2,945
"429",97347,56,49,-7,945
"430",97348,110,106,-4,945
"431",97349,105,102,-3,945
"432",98046,13,18,5,945
"433",98047,17,11,-6,945
"434",98048,18,11,-7,945
"435",98049,19,11,-8,945
"436",98050,19,11,-8,945
"437",98051,19,14,-5,945
"438",98052,20,14,-6,945
"439",98053,20,18,-2,945
"440",98054,20,18,-2,945
"441",98055,20,18,-2,945
"442",98056,21,18,-3,945
"443",98057,20,17,-3,945
"444",98058,20,18,-2,945
"445",98059,20,18,-2,945
"446",98060,20,18,-2,945
"447",98061,20,18,-2,945
"448",98062,20,18,-2,945
"449",98063,20,18,-2,945
"450",98064,20,18,-2,945
"451",98065,20,18,-2,945
"452",98066,20,18,-2,945
"453",98067,101,99,-2,945
"454",98068,100,100,0,945
"455",98069,98,97,-1,945
"456",98070,90,90,0,945
"457",98767,18,11,-7,945
"458",98768,19,11,-8,945
"459",98769,19,11,-8,945
"460",98770,19,11,-8,945
"461",98771,19,17,-2,945
"462",98772,20,17,-3,945
"463",98773,20,18,-2,945
"464",98774,20,18,-2,945
"465",98775,21,18,-3,945
"466",98776,21,18,-3,945
"467",98777,20,18,-2,945
"468",98778,20,18,-2,945
"469",98779,20,18,-2,945
"470",98780,20,18,-2,945
"471",98781,20,18,-2,945
"472",98782,20,18,-2,945
"473",98783,20,18,-2,945
"474",98784,20,18,-2,945
"475",98785,18,17,-1,945
"476",98786,18,17,-1,945
"477",98787,21,17,-4,945
"478",98788,80,76,-4,945
"479",98789,81,76,-5,945
"480",98790,78,74,-4,945
"481",99486,15,11,-4,945
"482",99487,18,11,-7,945
"483",99488,18,11,-7,945
"484",99489,19,11,-8,945
"485",99490,20,11,-9,945
"486",99491,20,17,-3,945
"487",99492,20,17,-3,945
"488",99493,20,18,-2,945
"489",99494,20,18,-2,945
"490",99495,20,18,-2,945
"491",99496,21,19,-2,945
"492",99497,19,18,-1,945
"493",99498,20,18,-2,945
"494",99499,20,18,-2,945
"495",99500,20,18,-2,945
"496",99501,20,18,-2,945
"497",99502,19,18,-1,945
"498",99503,19,18,-1,945
"499",99504,19,18,-1,945
"500",99505,17,17,0,945
"501",99506,18,17,-1,945
"502",99507,19,16,-3,945
"503",99508,54,46,-8,945
"504",99509,96,95,-1,945
"505",99510,95,95,0,945
"506",100205,14,11,-3,945
"507",100206,14,11,-3,945
"508",100207,18,16,-2,945
"509",100208,18,16,-2,945
"510",100209,19,17,-2,945
"511",100210,20,17,-3,945
"512",100211,20,18,-2,945
"513",100212,20,18,-2,945
"514",100213,19,18,-1,945
"515",100214,19,18,-1,945
"516",100215,20,19,-1,945
"517",100216,20,19,-1,945
"518",100217,19,18,-1,945
"519",100218,19,18,-1,945
"520",100219,19,18,-1,945
"521",100220,19,18,-1,945
"522",100221,19,18,-1,945
"523",100222,19,18,-1,945
"524",100223,19,18,-1,945
"525",100224,19,18,-1,945
"526",100225,18,16,-2,945
"527",100226,18,16,-2,945
"528",100227,19,16,-3,945
"529",100228,20,16,-4,945
"530",100229,76,75,-1,945
"531",100230,74,75,1,945
"532",100924,12,11,-1,945
"533",100925,13,11,-2,945
"534",100926,14,11,-3,945
"535",100927,15,16,1,945
"536",100928,18,16,-2,945
"537",100929,19,17,-2,945
"538",100930,20,17,-3,945
"539",100931,20,18,-2,945
"540",100932,19,18,-1,945
"541",100933,19,18,-1,945
"542",100934,19,18,-1,945
"543",100935,20,19,-1,945
"544",100936,20,19,-1,945
"545",100937,19,18,-1,945
"546",100938,19,18,-1,945
"547",100939,19,18,-1,945
"548",100940,19,18,-1,945
"549",100941,19,18,-1,945
"550",100942,19,18,-1,945
"551",100943,19,18,-1,945
"552",100944,19,18,-1,945
"553",100945,18,16,-2,945
"554",100946,18,16,-2,945
"555",100947,19,16,-3,945
"556",100948,20,16,-4,945
"557",100949,67,64,-3,945
"558",100950,64,62,-2,945
"559",101644,12,15,3,945
"560",101645,13,17,4,945
"561",101646,13,17,4,945
"562",101647,15,17,2,945
"563",101648,16,17,1,945
"564",101649,17,18,1,945
"565",101650,17,18,1,945
"566",101651,19,18,-1,945
"567",101652,19,18,-1,945
"568",101653,19,18,-1,945
"569",101654,18,18,0,945
"570",101655,17,19,2,945
"571",101656,18,19,1,945
"572",101657,18,18,0,945
"573",101658,18,18,0,945
"574",101659,16,16,0,945
"575",101660,18,18,0,945
"576",101661,19,18,-1,945
"577",101662,19,18,-1,945
"578",101663,19,18,-1,945
"579",101664,19,18,-1,945
"580",101665,18,17,-1,945
"581",101666,19,17,-2,945
"582",101667,19,17,-2,945
"583",101668,19,17,-2,945
"584",101669,21,20,-1,945
"585",101670,83,80,-3,945
"586",101671,87,84,-3,945
"587",101672,82,80,-2,945
"588",102364,12,15,3,945
"589",102365,12,17,5,945
"590",102366,12,17,5,945
"591",102367,15,17,2,945
"592",102368,15,17,2,945
"593",102369,16,18,2,945
"594",102370,16,18,2,945
"595",102371,16,18,2,945
"596",102372,17,18,1,945
"597",102373,17,18,1,945
"598",102374,17,19,2,945
"599",102375,16,19,3,945
"600",102376,14,19,5,945
"601",102377,15,18,3,945
"602",102378,31,27,-4,945
"603",102379,30,25,-5,945
"604",102380,18,18,0,945
"605",102381,19,18,-1,945
"606",102382,18,18,0,945
"607",102383,19,18,-1,945
"608",102384,18,18,0,945
"609",102385,18,17,-1,945
"610",102386,18,17,-1,945
"611",102387,19,17,-2,945
"612",102388,19,17,-2,945
"613",102389,18,18,0,945
"614",102390,20,19,-1,945
"615",102391,26,25,-1,945
"616",102392,87,84,-3,945
"617",102393,87,82,-5,945
"618",103084,12,18,6,945
"619",103085,12,18,6,945
"620",103086,12,18,6,945
"621",103087,13,18,5,945
"622",103088,15,18,3,945
"623",103089,15,18,3,945
"624",103090,15,18,3,945
"625",103091,15,16,1,945
"626",103092,16,18,2,945
"627",103093,15,18,3,945
"628",103094,15,19,4,945
"629",103095,14,18,4,945
"630",103096,14,18,4,945
"631",103097,14,18,4,945
"632",103098,14,18,4,945
"633",103099,14,18,4,945
"634",103100,15,18,3,945
"635",103101,15,18,3,945
"636",103102,13,18,5,945
"637",103103,15,18,3,945
"638",103104,17,18,1,945
"639",103105,18,18,0,945
"640",103106,18,18,0,945
"641",103107,19,18,-1,945
"642",103108,19,18,-1,945
"643",103109,18,18,0,945
"644",103110,19,18,-1,945
"645",103111,18,18,0,945
"646",103112,23,22,-1,945
"647",103113,85,81,-4,945
"648",103114,83,79,-4,945
"649",103115,82,76,-6,945
"650",103116,63,58,-5,945
"651",103804,12,18,6,945
"652",103805,13,18,5,945
"653",103806,13,18,5,945
"654",103807,13,18,5,945
"655",103808,13,18,5,945
"656",103809,14,18,4,945
"657",103810,14,18,4,945
"658",103811,14,18,4,945
"659",103812,14,18,4,945
"660",103813,14,17,3,945
"661",103814,14,18,4,945
"662",103815,14,18,4,945
"663",103816,14,18,4,945
"664",103817,13,18,5,945
"665",103818,13,18,5,945
"666",103819,13,18,5,945
"667",103820,12,18,6,945
"668",103821,12,18,6,945
"669",103822,12,18,6,945
"670",103823,13,18,5,945
"671",103824,16,18,2,945
"672",103825,18,18,0,945
"673",103826,18,18,0,945
"674",103827,18,18,0,945
"675",103828,19,18,-1,945
"676",103829,19,17,-2,945
"677",103830,19,17,-2,945
"678",103831,19,18,-1,945
"679",103832,19,18,-1,945
"680",103833,20,18,-2,945
"681",103834,24,22,-2,945
"682",103835,60,52,-8,945
"683",103836,83,79,-4,945
"684",103837,81,79,-2,945
"685",103838,78,72,-6,945
"686",104524,13,18,5,945
"687",104525,13,18,5,945
"688",104526,13,18,5,945
"689",104527,13,18,5,945
"690",104528,13,18,5,945
"691",104529,14,18,4,945
"692",104530,14,18,4,945
"693",104531,14,18,4,945
"694",104532,14,18,4,945
"695",104533,14,17,3,945
"696",104534,14,17,3,945
"697",104535,14,18,4,945
"698",104536,14,18,4,945
"699",104537,13,18,5,945
"700",104538,13,18,5,945
"701",104539,13,18,5,945
"702",104540,12,18,6,945
"703",104541,11,18,7,945
"704",104542,11,18,7,945
"705",104543,12,18,6,945
"706",104544,15,18,3,945
"707",104545,18,18,0,945
"708",104546,18,18,0,945
"709",104547,18,18,0,945
"710",104548,19,18,-1,945
"711",104549,19,17,-2,945
"712",104550,19,17,-2,945
"713",104551,19,18,-1,945
"714",104552,19,18,-1,945
"715",104553,19,18,-1,945
"716",104554,19,18,-1,945
"717",104555,20,18,-2,945
"718",104556,22,20,-2,945
"719",104557,25,23,-2,945
"720",104558,85,80,-5,945
"721",104559,83,80,-3,945
"722",104560,79,76,-3,945
"723",105245,13,18,5,945
"724",105246,13,18,5,945
"725",105247,14,17,3,945
"726",105248,14,17,3,945
"727",105249,14,17,3,945
"728",105250,14,17,3,945
"729",105251,14,17,3,945
"730",105252,14,17,3,945
"731",105253,14,17,3,945
"732",105254,14,17,3,945
"733",105255,14,18,4,945
"734",105256,13,18,5,945
"735",105257,13,18,5,945
"736",105258,13,18,5,945
"737",105259,13,18,5,945
"738",105260,11,18,7,945
"739",105261,11,18,7,945
"740",105262,11,18,7,945
"741",105263,12,18,6,945
"742",105264,14,18,4,945
"743",105265,16,18,2,945
"744",105266,18,18,0,945
"745",105267,19,18,-1,945
"746",105268,19,18,-1,945
"747",105269,20,18,-2,945
"748",105270,20,17,-3,945
"749",105271,18,16,-2,945
"750",105272,18,16,-2,945
"751",105273,18,16,-2,945
"752",105274,18,16,-2,945
"753",105275,18,16,-2,945
"754",105276,18,16,-2,945
"755",105277,20,18,-2,945
"756",105278,21,19,-2,945
"757",105279,26,23,-3,945
"758",105280,83,81,-2,945
"759",105281,83,83,0,945
"760",105282,83,82,-1,945
"761",105283,75,75,0,945
"762",105965,14,17,3,945
"763",105966,14,17,3,945
"764",105967,14,17,3,945
"765",105968,14,17,3,945
"766",105969,14,17,3,945
"767",105970,14,17,3,945
"768",105971,14,17,3,945
"769",105972,14,17,3,945
"770",105973,14,17,3,945
"771",105974,14,17,3,945
"772",105975,13,18,5,945
"773",105976,13,18,5,945
"774",105977,13,18,5,945
"775",105978,14,18,4,945
"776",105979,13,18,5,945
"777",105980,12,18,6,945
"778",105981,13,18,5,945
"779",105982,14,19,5,945
"780",105983,15,19,4,945
"781",105984,14,18,4,945
"782",105987,19,18,-1,945
"783",105988,19,18,-1,945
"784",105989,19,18,-1,945
"785",105990,20,17,-3,945
"786",105991,19,16,-3,945
"787",105992,18,16,-2,945
"788",105993,18,16,-2,945
"789",105994,18,16,-2,945
"790",105995,18,10,-8,945
"791",105996,18,10,-8,945
"792",105997,18,16,-2,945
"793",105998,18,16,-2,945
"794",105999,20,18,-2,945
"795",106000,21,19,-2,945
"796",106001,23,21,-2,945
"797",106002,29,26,-3,945
"798",106003,86,82,-4,945
"799",106004,85,83,-2,945
"800",106005,80,77,-3,945
"801",106010,78,77,-1,945
"802",106011,77,77,0,945
"803",106012,78,77,-1,945
"804",106686,14,17,3,945
"805",106687,14,17,3,945
"806",106688,14,17,3,945
"807",106689,14,17,3,945
"808",106690,14,17,3,945
"809",106691,14,17,3,945
"810",106692,14,17,3,945
"811",106693,14,17,3,945
"812",106694,13,17,4,945
"813",106695,13,18,5,945
"814",106696,14,18,4,945
"815",106697,14,18,4,945
"816",106698,13,18,5,945
"817",106699,12,18,6,945
"818",106700,12,18,6,945
"819",106701,13,18,5,945
"820",106702,13,18,5,945
"821",106703,14,18,4,945
"822",106709,19,18,-1,945
"823",106710,18,17,-1,945
"824",106711,19,16,-3,945
"825",106712,18,16,-2,945
"826",106713,18,16,-2,945
"827",106714,18,14,-4,945
"828",106715,18,9,-9,945
"829",106716,18,10,-8,945
"830",106717,18,16,-2,945
"831",106718,18,16,-2,945
"832",106719,20,18,-2,945
"833",106720,20,18,-2,945
"834",106721,20,18,-2,945
"835",106722,20,18,-2,945
"836",106723,23,22,-1,945
"837",106724,26,25,-1,945
"838",106725,88,84,-4,945
"839",106726,88,84,-4,945
"840",106727,87,84,-3,945
"841",106728,85,84,-1,945
"842",106729,87,86,-1,945
"843",106730,87,86,-1,945
"844",106731,74,69,-5,945
"845",106732,81,78,-3,945
"846",106733,82,79,-3,945
"847",106734,80,77,-3,945
"848",107407,14,17,3,945
"849",107408,14,17,3,945
"850",107409,14,17,3,945
"851",107410,15,17,2,945
"852",107411,15,17,2,945
"853",107412,14,17,3,945
"854",107413,14,17,3,945
"855",107414,14,18,4,945
"856",107415,14,19,5,945
"857",107417,13,19,6,945
"858",107418,13,19,6,945
"859",107419,12,19,7,945
"860",107420,12,19,7,945
"861",107430,19,18,-1,945
"862",107431,18,16,-2,945
"863",107432,18,15,-3,945
"864",107433,18,13,-5,945
"865",107434,18,11,-7,945
"866",107435,18,11,-7,945
"867",107436,18,16,-2,945
"868",107437,18,17,-1,945
"869",107438,18,17,-1,945
"870",107439,20,19,-1,945
"871",107440,20,19,-1,945
"872",107441,20,19,-1,945
"873",107442,20,19,-1,945
"874",107443,19,19,0,945
"875",107444,19,19,0,945
"876",107445,19,19,0,945
"877",107446,19,19,0,945
"878",107447,20,20,0,945
"879",107448,20,20,0,945
"880",107449,21,21,0,945
"881",107450,22,22,0,945
"882",107451,50,46,-4,945
"883",107452,51,47,-4,945
"884",107453,80,77,-3,945
"885",107454,88,85,-3,945
"886",107455,82,81,-1,945
"887",108152,17,14,-3,945
"888",108153,17,11,-6,945
"889",108154,18,11,-7,945
"890",108155,18,11,-7,945
"891",108156,18,13,-5,945
"892",108157,18,18,0,945
"893",108158,18,18,0,945
"894",108159,20,19,-1,945
"895",108160,20,19,-1,945
"896",108161,20,19,-1,945
"897",108162,20,19,-1,945
"898",108163,20,19,-1,945
"899",108164,20,19,-1,945
"900",108165,20,19,-1,945
"901",108166,19,19,0,945
"902",108167,19,19,0,945
"903",108168,19,19,0,945
"904",108169,19,19,0,945
"905",108170,19,19,0,945
"906",108171,19,19,0,945
"907",108172,58,53,-5,945
"908",108173,61,57,-4,945
"909",108174,81,79,-2,945
"910",108175,88,87,-1,945
"911",108176,82,81,-1,945
"912",108875,17,11,-6,945
"913",108876,17,11,-6,945
"914",108877,18,14,-4,945
"915",108878,18,18,0,945
"916",108879,20,19,-1,945
"917",108880,20,19,-1,945
"918",108881,20,19,-1,945
"919",108882,20,19,-1,945
"920",108883,20,19,-1,945
"921",108884,20,19,-1,945
"922",108885,19,19,0,945
"923",108886,19,19,0,945
"924",108887,19,19,0,945
"925",108888,19,19,0,945
"926",108889,19,19,0,945
"927",108890,18,18,0,945
"928",108891,18,18,0,945
"929",108892,19,18,-1,945
"930",108893,20,19,-1,945
"931",108894,33,33,0,945
"932",108895,80,76,-4,945
"933",108896,91,90,-1,945
"934",109597,17,12,-5,945
"935",109598,18,18,0,945
"936",109599,19,19,0,945
"937",109600,19,19,0,945
"938",109601,20,19,-1,945
"939",109602,20,19,-1,945
"940",109603,20,19,-1,945
"941",109604,19,19,0,945
"942",109605,19,19,0,945
"943",109606,19,19,0,945
"944",109607,19,19,0,945
"945",109608,19,19,0,945
"946",109609,19,19,0,945
"947",109610,19,19,0,945
"948",109611,19,19,0,945
"949",109612,19,18,-1,945
"950",109613,20,19,-1,945
"951",109614,21,19,-2,945
"952",109615,23,21,-2,945
"953",110319,17,19,2,945
"954",110320,17,19,2,945
"955",110321,17,17,0,945
"956",110322,17,17,0,945
"957",110323,17,17,0,945
"958",110324,17,17,0,945
"959",110325,17,17,0,945
"960",110326,17,17,0,945
"961",110327,17,17,0,945
"962",110328,16,16,0,945
"963",110329,16,16,0,945
"964",110330,16,16,0,945
"965",110331,16,16,0,945
"966",110332,17,16,-1,945
"967",110333,18,18,0,945
"968",110334,18,18,0,945
"969",111042,17,16,-1,945
"970",111043,17,16,-1,945
"971",111044,17,16,-1,945
"972",111045,17,16,-1,945
"973",111046,17,16,-1,945
"974",111047,16,16,0,945
"975",111048,16,16,0,945
"976",111049,16,16,0,945
"977",111050,16,16,0,945
"978",111051,16,16,0,945
"979",111052,16,16,0,945
"980",111053,18,18,0,945
"981",111765,17,12,-5,945
"982",111766,17,14,-3,945
"983",111767,17,15,-2,945
"984",111768,16,15,-1,945
"985",111769,15,9,-6,945
"986",111770,15,9,-6,945
"987",111771,15,9,-6,945
"988",111772,16,9,-7,945
"989",34583,46,53,7,959
"990",34584,46,53,7,959
"991",34585,40,48,8,959
"992",35300,49,53,4,959
"993",35301,50,56,6,959
"994",35302,49,53,4,959
"995",35303,51,53,2,959
"996",35304,53,55,2,959
"997",35305,51,51,0,959
"998",35306,46,49,3,959
"999",35307,41,42,1,959
"1000",35308,9,9,0,959
"1001",36018,52,54,2,959
"1002",36019,58,56,-2,959
"1003",36020,57,57,0,959
"1004",36021,55,57,2,959
"1005",36022,53,54,1,959
"1006",36023,55,54,-1,959
"1007",36024,56,56,0,959
"1008",36025,51,53,2,959
"1009",36026,53,54,1,959
"1010",36027,52,53,1,959
"1011",36028,45,49,4,959
"1012",36029,25,27,2,959
"1013",36031,10,10,0,959
"1014",36032,25,32,7,959
"1015",36033,26,29,3,959
"1016",36034,24,23,-1,959
"1017",36035,1,1,0,959
"1018",36036,26,22,-4,959
"1019",36037,26,23,-3,959
"1020",36038,21,20,-1,959
"1021",36039,20,19,-1,959
"1022",36736,52,53,1,959
"1023",36737,56,52,-4,959
"1024",36738,54,53,-1,959
"1025",36739,57,53,-4,959
"1026",36740,54,54,0,959
"1027",36741,53,54,1,959
"1028",36742,53,53,0,959
"1029",36743,53,54,1,959
"1030",36744,56,54,-2,959
"1031",36745,56,53,-3,959
"1032",36746,56,54,-2,959
"1033",36747,55,55,0,959
"1034",36748,53,51,-2,959
"1035",36749,50,49,-1,959
"1036",36750,48,51,3,959
"1037",36751,38,45,7,959
"1038",36752,38,41,3,959
"1039",36753,39,42,3,959
"1040",36754,38,40,2,959
"1041",36755,29,31,2,959
"1042",36756,32,31,-1,959
"1043",36757,36,32,-4,959
"1044",36758,31,27,-4,959
"1045",36759,19,18,-1,959
"1046",37454,57,56,-1,959
"1047",37455,54,54,0,959
"1048",37456,55,55,0,959
"1049",37457,56,54,-2,959
"1050",37458,54,51,-3,959
"1051",37459,60,54,-6,959
"1052",37460,56,53,-3,959
"1053",37461,58,54,-4,959
"1054",37462,54,53,-1,959
"1055",37463,55,54,-1,959
"1056",37464,56,54,-2,959
"1057",37465,55,54,-1,959
"1058",37466,55,56,1,959
"1059",37467,54,54,0,959
"1060",37468,54,52,-2,959
"1061",37469,52,50,-2,959
"1062",37470,48,48,0,959
"1063",37471,44,44,0,959
"1064",37472,37,42,5,959
"1065",37473,31,37,6,959
"1066",37474,30,36,6,959
"1067",37475,28,33,5,959
"1068",37476,32,34,2,959
"1069",37477,34,30,-4,959
"1070",37478,31,28,-3,959
"1071",37479,28,24,-4,959
"1072",38172,57,53,-4,959
"1073",38173,58,55,-3,959
"1074",38174,58,55,-3,959
"1075",38175,56,53,-3,959
"1076",38176,58,54,-4,959
"1077",38177,60,57,-3,959
"1078",38178,59,56,-3,959
"1079",38179,60,54,-6,959
"1080",38180,53,50,-3,959
"1081",38181,48,50,2,959
"1082",38182,53,51,-2,959
"1083",38183,57,52,-5,959
"1084",38184,59,53,-6,959
"1085",38185,54,55,1,959
"1086",38186,54,53,-1,959
"1087",38187,52,53,1,959
"1088",38188,52,51,-1,959
"1089",38189,52,50,-2,959
"1090",38190,49,48,-1,959
"1091",38191,46,47,1,959
"1092",38192,36,42,6,959
"1093",38193,29,37,8,959
"1094",38194,31,36,5,959
"1095",38195,29,33,4,959
"1096",38196,28,25,-3,959
"1097",38197,22,19,-3,959
"1098",38890,60,54,-6,959
"1099",38891,59,57,-2,959
"1100",38892,57,56,-1,959
"1101",38893,61,56,-5,959
"1102",38894,60,55,-5,959
"1103",38895,48,55,7,959
"1104",38896,49,56,7,959
"1105",38897,59,57,-2,959
"1106",38898,57,53,-4,959
"1107",38899,57,53,-4,959
"1108",38900,55,52,-3,959
"1109",38901,58,52,-6,959
"1110",38902,57,51,-6,959
"1111",38903,56,52,-4,959
"1112",38904,59,53,-6,959
"1113",38905,53,53,0,959
"1114",38906,55,53,-2,959
"1115",38907,54,54,0,959
"1116",38908,52,53,1,959
"1117",38909,53,53,0,959
"1118",38910,56,50,-6,959
"1119",38911,46,48,2,959
"1120",39608,60,54,-6,959
"1121",39609,61,55,-6,959
"1122",39610,60,54,-6,959
"1123",39611,58,56,-2,959
"1124",39612,57,55,-2,959
"1125",39613,59,55,-4,959
"1126",39614,60,56,-4,959
"1127",39615,51,57,6,959
"1128",39616,48,54,6,959
"1129",39617,60,57,-3,959
"1130",39618,59,56,-3,959
"1131",39619,60,57,-3,959
"1132",39620,59,53,-6,959
"1133",39621,60,52,-8,959
"1134",39622,57,51,-6,959
"1135",39623,57,51,-6,959
"1136",39624,59,52,-7,959
"1137",39625,56,55,-1,959
"1138",39626,54,54,0,959
"1139",39627,55,55,0,959
"1140",39628,56,54,-2,959
"1141",39629,55,57,2,959
"1142",39630,48,50,2,959
"1143",40326,55,54,-1,959
"1144",40327,57,54,-3,959
"1145",40328,59,55,-4,959
"1146",40329,60,57,-3,959
"1147",40330,60,57,-3,959
"1148",40331,61,57,-4,959
"1149",40332,59,57,-2,959
"1150",40333,58,57,-1,959
"1151",40334,57,57,0,959
"1152",40335,60,55,-5,959
"1153",40336,60,58,-2,959
"1154",40337,59,57,-2,959
"1155",40338,58,58,0,959
"1156",40339,60,56,-4,959
"1157",40340,60,55,-5,959
"1158",40341,57,53,-4,959
"1159",40342,56,54,-2,959
"1160",40343,57,56,-1,959
"1161",40344,57,53,-4,959
"1162",40345,59,55,-4,959
"1163",40346,60,56,-4,959
"1164",40347,60,58,-2,959
"1165",40348,60,62,2,959
"1166",40349,56,60,4,959
"1167",41044,47,47,0,959
"1168",41045,54,50,-4,959
"1169",41046,54,53,-1,959
"1170",41047,54,55,1,959
"1171",41048,58,56,-2,959
"1172",41049,60,57,-3,959
"1173",41050,60,57,-3,959
"1174",41051,60,58,-2,959
"1175",41052,61,58,-3,959
"1176",41053,61,57,-4,959
"1177",41054,62,58,-4,959
"1178",41055,62,55,-7,959
"1179",41056,60,56,-4,959
"1180",41057,62,59,-3,959
"1181",41058,61,58,-3,959
"1182",41059,63,59,-4,959
"1183",41060,61,56,-5,959
"1184",41061,60,54,-6,959
"1185",41062,57,55,-2,959
"1186",41063,57,56,-1,959
"1187",41064,57,56,-1,959
"1188",41065,57,56,-1,959
"1189",41066,55,53,-2,959
"1190",41067,59,59,0,959
"1191",41068,58,59,1,959
"1192",41069,62,59,-3,959
"1193",41070,61,59,-2,959
"1194",41098,50,45,-5,959
"1195",41099,55,49,-6,959
"1196",41100,50,47,-3,959
"1197",41101,42,42,0,959
"1198",41102,3,4,1,959
"1199",41104,45,49,4,959
"1200",41105,47,49,2,959
"1201",41106,18,20,2,959
"1202",41107,39,42,3,959
"1203",41108,41,39,-2,959
"1204",41762,37,39,2,959
"1205",41763,46,46,0,959
"1206",41764,52,53,1,959
"1207",41765,55,53,-2,959
"1208",41766,57,56,-1,959
"1209",41767,56,54,-2,959
"1210",41768,59,59,0,959
"1211",41769,60,59,-1,959
"1212",41770,60,58,-2,959
"1213",41771,60,60,0,959
"1214",41772,61,61,0,959
"1215",41773,62,61,-1,959
"1216",41774,66,63,-3,959
"1217",41775,66,63,-3,959
"1218",41776,65,61,-4,959
"1219",41777,65,62,-3,959
"1220",41778,64,63,-1,959
"1221",41779,65,64,-1,959
"1222",41780,65,61,-4,959
"1223",41781,64,59,-5,959
"1224",41782,59,58,-1,959
"1225",41783,58,58,0,959
"1226",41784,57,59,2,959
"1227",41785,60,60,0,959
"1228",41786,62,61,-1,959
"1229",41787,62,60,-2,959
"1230",41788,60,61,1,959
"1231",41789,65,65,0,959
"1232",41790,67,63,-4,959
"1233",41791,63,63,0,959
"1234",41816,67,60,-7,959
"1235",41817,78,70,-8,959
"1236",41818,71,64,-7,959
"1237",41819,56,52,-4,959
"1238",41820,40,38,-2,959
"1239",41821,40,36,-4,959
"1240",41822,36,36,0,959
"1241",41823,23,28,5,959
"1242",41824,67,64,-3,959
"1243",41825,69,65,-4,959
"1244",41826,72,65,-7,959
"1245",41827,72,67,-5,959
"1246",41828,69,68,-1,959
"1247",41829,55,57,2,959
"1248",42481,5,6,1,959
"1249",42482,27,27,0,959
"1250",42483,47,45,-2,959
"1251",42484,52,52,0,959
"1252",42485,52,53,1,959
"1253",42486,56,53,-3,959
"1254",42487,54,53,-1,959
"1255",42488,56,55,-1,959
"1256",42489,59,60,1,959
"1257",42490,60,60,0,959
"1258",42491,60,61,1,959
"1259",42492,61,61,0,959
"1260",42493,61,61,0,959
"1261",42494,64,63,-1,959
"1262",42495,66,64,-2,959
"1263",42496,66,65,-1,959
"1264",42497,65,63,-2,959
"1265",42498,64,61,-3,959
"1266",42499,66,64,-2,959
"1267",42500,65,62,-3,959
"1268",42501,64,64,0,959
"1269",42502,63,61,-2,959
"1270",42503,61,60,-1,959
"1271",42504,61,61,0,959
"1272",42505,64,63,-1,959
"1273",42506,66,65,-1,959
"1274",42507,66,65,-1,959
"1275",42508,64,67,3,959
"1276",42509,68,66,-2,959
"1277",42510,69,66,-3,959
"1278",42511,68,66,-2,959
"1279",42512,60,63,3,959
"1280",42516,20,26,6,959
"1281",42535,73,69,-4,959
"1282",42536,79,73,-6,959
"1283",42537,75,72,-3,959
"1284",42538,71,64,-7,959
"1285",42542,0,0,0,959
"1286",42544,70,67,-3,959
"1287",42545,71,68,-3,959
"1288",42546,72,68,-4,959
"1289",42547,73,69,-4,959
"1290",42548,73,68,-5,959
"1291",42549,70,64,-6,959
"1292",42550,68,60,-8,959
"1293",42551,53,47,-6,959
"1294",42552,54,46,-8,959
"1295",42553,46,44,-2,959
"1296",42554,50,44,-6,959
"1297",42555,52,46,-6,959
"1298",42556,53,46,-7,959
"1299",42557,38,37,-1,959
"1300",42558,37,35,-2,959
"1301",42561,4,6,2,959
"1302",42562,4,6,2,959
"1303",43201,2,1,-1,959
"1304",43202,10,8,-2,959
"1305",43203,46,46,0,959
"1306",43204,50,48,-2,959
"1307",43205,51,49,-2,959
"1308",43206,57,57,0,959
"1309",43207,57,58,1,959
"1310",43208,57,59,2,959
"1311",43209,56,60,4,959
"1312",43210,58,57,-1,959
"1313",43211,62,61,-1,959
"1314",43212,63,61,-2,959
"1315",43213,62,60,-2,959
"1316",43214,62,61,-1,959
"1317",43215,63,62,-1,959
"1318",43216,64,62,-2,959
"1319",43217,63,61,-2,959
"1320",43218,65,62,-3,959
"1321",43219,68,65,-3,959
"1322",43220,67,66,-1,959
"1323",43221,69,64,-5,959
"1324",43222,65,61,-4,959
"1325",43223,65,60,-5,959
"1326",43224,64,61,-3,959
"1327",43225,64,61,-3,959
"1328",43226,72,66,-6,959
"1329",43227,72,71,-1,959
"1330",43228,73,70,-3,959
"1331",43229,71,66,-5,959
"1332",43230,69,68,-1,959
"1333",43231,66,63,-3,959
"1334",43232,66,65,-1,959
"1335",43233,68,66,-2,959
"1336",43234,70,66,-4,959
"1337",43235,70,68,-2,959
"1338",43236,74,72,-2,959
"1339",43237,68,71,3,959
"1340",43253,71,68,-3,959
"1341",43254,83,76,-7,959
"1342",43255,85,77,-8,959
"1343",43256,74,66,-8,959
"1344",43257,79,72,-7,959
"1345",43258,80,70,-10,959
"1346",43259,64,61,-3,959
"1347",43260,79,73,-6,959
"1348",43261,83,76,-7,959
"1349",43262,80,75,-5,959
"1350",43263,77,75,-2,959
"1351",43264,77,73,-4,959
"1352",43265,76,70,-6,959
"1353",43266,75,72,-3,959
"1354",43267,70,65,-5,959
"1355",43268,65,61,-4,959
"1356",43269,65,61,-4,959
"1357",43270,67,61,-6,959
"1358",43271,77,73,-4,959
"1359",43272,76,66,-10,959
"1360",43273,71,65,-6,959
"1361",43274,64,59,-5,959
"1362",43275,62,56,-6,959
"1363",43276,67,62,-5,959
"1364",43277,75,65,-10,959
"1365",43278,78,69,-9,959
"1366",43279,77,68,-9,959
"1367",43280,78,70,-8,959
"1368",43281,74,68,-6,959
"1369",43282,61,59,-2,959
"1370",43922,4,2,-2,959
"1371",43923,13,9,-4,959
"1372",43924,50,49,-1,959
"1373",43925,56,58,2,959
"1374",43926,58,58,0,959
"1375",43927,58,57,-1,959
"1376",43928,60,60,0,959
"1377",43929,60,61,1,959
"1378",43930,62,63,1,959
"1379",43931,61,61,0,959
"1380",43932,66,63,-3,959
"1381",43933,66,64,-2,959
"1382",43934,65,62,-3,959
"1383",43935,66,64,-2,959
"1384",43936,65,63,-2,959
"1385",43937,65,62,-3,959
"1386",43938,68,64,-4,959
"1387",43939,67,63,-4,959
"1388",43940,68,65,-3,959
"1389",43941,68,65,-3,959
"1390",43942,67,65,-2,959
"1391",43943,68,63,-5,959
"1392",43944,66,65,-1,959
"1393",43945,66,63,-3,959
"1394",43946,67,63,-4,959
"1395",43947,70,67,-3,959
"1396",43948,67,66,-1,959
"1397",43949,68,64,-4,959
"1398",43950,65,63,-2,959
"1399",43951,62,63,1,959
"1400",43952,64,64,0,959
"1401",43953,66,63,-3,959
"1402",43954,65,63,-2,959
"1403",43955,70,66,-4,959
"1404",43956,72,72,0,959
"1405",43957,67,69,2,959
"1406",43959,11,15,4,959
"1407",43960,12,17,5,959
"1408",43964,1,2,1,959
"1409",43972,72,68,-4,959
"1410",43973,83,75,-8,959
"1411",43974,82,74,-8,959
"1412",43975,77,70,-7,959
"1413",43976,80,72,-8,959
"1414",43977,82,77,-5,959
"1415",43978,80,76,-4,959
"1416",43979,79,75,-4,959
"1417",43980,81,78,-3,959
"1418",43981,73,67,-6,959
"1419",43982,69,65,-4,959
"1420",43983,68,65,-3,959
"1421",43984,68,67,-1,959
"1422",43985,72,67,-5,959
"1423",43986,67,63,-4,959
"1424",43987,66,65,-1,959
"1425",43988,67,64,-3,959
"1426",43989,55,51,-4,959
"1427",43990,40,37,-3,959
"1428",43991,15,16,1,959
"1429",43992,11,11,0,959
"1430",43993,11,11,0,959
"1431",43994,11,11,0,959
"1432",43995,11,11,0,959
"1433",43996,43,37,-6,959
"1434",43997,59,54,-5,959
"1435",43998,62,56,-6,959
"1436",43999,66,57,-9,959
"1437",44000,69,63,-6,959
"1438",44001,78,72,-6,959
"1439",44002,76,74,-2,959
"1440",44003,74,71,-3,959
"1441",44004,71,68,-3,959
"1442",44007,14,15,1,959
"1443",44008,14,15,1,959
"1444",44009,6,6,0,959
"1445",44010,6,6,0,959
"1446",44643,5,4,-1,959
"1447",44644,22,18,-4,959
"1448",44645,27,27,0,959
"1449",44646,27,27,0,959
"1450",44647,62,58,-4,959
"1451",44648,63,61,-2,959
"1452",44649,66,65,-1,959
"1453",44650,68,64,-4,959
"1454",44651,68,64,-4,959
"1455",44652,63,60,-3,959
"1456",44653,64,65,1,959
"1457",44654,65,63,-2,959
"1458",44655,67,65,-2,959
"1459",44656,68,66,-2,959
"1460",44657,66,64,-2,959
"1461",44658,68,66,-2,959
"1462",44659,67,66,-1,959
"1463",44660,69,62,-7,959
"1464",44661,69,63,-6,959
"1465",44662,69,64,-5,959
"1466",44663,69,64,-5,959
"1467",44664,70,66,-4,959
"1468",44665,72,65,-7,959
"1469",44666,70,65,-5,959
"1470",44667,69,65,-4,959
"1471",44668,68,64,-4,959
"1472",44669,67,64,-3,959
"1473",44670,67,63,-4,959
"1474",44671,66,63,-3,959
"1475",44672,67,64,-3,959
"1476",44673,70,66,-4,959
"1477",44674,70,66,-4,959
"1478",44675,69,67,-2,959
"1479",44676,79,76,-3,959
"1480",44677,81,77,-4,959
"1481",44678,77,76,-1,959
"1482",44679,80,77,-3,959
"1483",44680,80,76,-4,959
"1484",44681,83,80,-3,959
"1485",44682,80,77,-3,959
"1486",44683,80,76,-4,959
"1487",44684,78,75,-3,959
"1488",44685,77,76,-1,959
"1489",44686,74,73,-1,959
"1490",44687,31,31,0,959
"1491",44693,85,79,-6,959
"1492",44694,88,80,-8,959
"1493",44695,88,77,-11,959
"1494",44696,86,77,-9,959
"1495",44697,88,78,-10,959
"1496",44698,70,66,-4,959
"1497",44699,74,69,-5,959
"1498",44700,76,71,-5,959
"1499",44701,71,68,-3,959
"1500",44702,71,67,-4,959
"1501",44703,71,67,-4,959
"1502",44704,64,59,-5,959
"1503",44705,28,26,-2,959
"1504",44706,12,11,-1,959
"1505",44707,8,8,0,959
"1506",44708,8,9,1,959
"1507",44709,5,6,1,959
"1508",44710,6,7,1,959
"1509",44711,6,7,1,959
"1510",44712,6,6,0,959
"1511",44713,6,6,0,959
"1512",44714,7,6,-1,959
"1513",44715,7,7,0,959
"1514",44716,9,10,1,959
"1515",44717,14,15,1,959
"1516",44718,25,26,1,959
"1517",44719,53,49,-4,959
"1518",44720,70,64,-6,959
"1519",44721,72,67,-5,959
"1520",44722,71,66,-5,959
"1521",44723,72,66,-6,959
"1522",44724,80,69,-11,959
"1523",44725,81,71,-10,959
"1524",44726,75,71,-4,959
"1525",44727,84,76,-8,959
"1526",44728,87,83,-4,959
"1527",44729,86,81,-5,959
"1528",44730,89,85,-4,959
"1529",44731,86,82,-4,959
"1530",45364,5,4,-1,959
"1531",45365,5,4,-1,959
"1532",45366,5,4,-1,959
"1533",45367,9,8,-1,959
"1534",45368,13,11,-2,959
"1535",45369,59,58,-1,959
"1536",45370,60,58,-2,959
"1537",45371,32,30,-2,959
"1538",45372,69,65,-4,959
"1539",45373,70,70,0,959
"1540",45374,68,68,0,959
"1541",45375,66,67,1,959
"1542",45376,65,66,1,959
"1543",45377,67,65,-2,959
"1544",45378,72,67,-5,959
"1545",45379,70,69,-1,959
"1546",45380,72,70,-2,959
"1547",45381,72,69,-3,959
"1548",45382,66,64,-2,959
"1549",45383,68,64,-4,959
"1550",45384,69,67,-2,959
"1551",45385,69,66,-3,959
"1552",45386,70,65,-5,959
"1553",45387,69,70,1,959
"1554",45388,74,74,0,959
"1555",45389,73,68,-5,959
"1556",45390,73,70,-3,959
"1557",45391,73,71,-2,959
"1558",45392,71,69,-2,959
"1559",45393,75,73,-2,959
"1560",45394,76,73,-3,959
"1561",45395,75,72,-3,959
"1562",45396,76,75,-1,959
"1563",45397,80,79,-1,959
"1564",45398,79,77,-2,959
"1565",45399,82,82,0,959
"1566",45400,79,81,2,959
"1567",45401,83,82,-1,959
"1568",45402,84,80,-4,959
"1569",45403,83,82,-1,959
"1570",45404,80,80,0,959
"1571",45405,79,78,-1,959
"1572",45406,41,44,3,959
"1573",45411,82,76,-6,959
"1574",45412,88,78,-10,959
"1575",45413,88,77,-11,959
"1576",45414,86,80,-6,959
"1577",45415,89,78,-11,959
"1578",45416,87,79,-8,959
"1579",45417,87,80,-7,959
"1580",45418,79,75,-4,959
"1581",45419,74,70,-4,959
"1582",45420,72,67,-5,959
"1583",45421,73,71,-2,959
"1584",45422,71,68,-3,959
"1585",45423,75,71,-4,959
"1586",45424,62,58,-4,959
"1587",45425,11,11,0,959
"1588",45426,8,8,0,959
"1589",45427,7,8,1,959
"1590",45428,5,6,1,959
"1591",45429,6,7,1,959
"1592",45430,6,7,1,959
"1593",45431,7,7,0,959
"1594",45432,6,6,0,959
"1595",45433,6,6,0,959
"1596",45434,7,6,-1,959
"1597",45435,7,7,0,959
"1598",45436,7,8,1,959
"1599",45437,7,8,1,959
"1600",45438,8,8,0,959
"1601",45439,8,8,0,959
"1602",45440,10,10,0,959
"1603",45441,49,49,0,959
"1604",45442,67,65,-2,959
"1605",45443,75,70,-5,959
"1606",45444,77,73,-4,959
"1607",45445,72,66,-6,959
"1608",45446,84,80,-4,959
"1609",45447,91,85,-6,959
"1610",45448,89,84,-5,959
"1611",45449,91,84,-7,959
"1612",45450,96,89,-7,959
"1613",45451,98,90,-8,959
"1614",45452,96,89,-7,959
"1615",45453,87,85,-2,959
"1616",46085,5,4,-1,959
"1617",46086,5,4,-1,959
"1618",46087,5,4,-1,959
"1619",46088,5,4,-1,959
"1620",46089,5,5,0,959
"1621",46090,5,5,0,959
"1622",46091,12,10,-2,959
"1623",46092,51,48,-3,959
"1624",46093,68,64,-4,959
"1625",46094,67,63,-4,959
"1626",46095,69,65,-4,959
"1627",46096,70,64,-6,959
"1628",46097,73,67,-6,959
"1629",46098,72,67,-5,959
"1630",46099,72,67,-5,959
"1631",46100,73,67,-6,959
"1632",46101,73,68,-5,959
"1633",46102,69,66,-3,959
"1634",46103,70,67,-3,959
"1635",46104,69,67,-2,959
"1636",46105,71,69,-2,959
"1637",46106,71,68,-3,959
"1638",46107,73,70,-3,959
"1639",46108,74,71,-3,959
"1640",46109,79,72,-7,959
"1641",46110,78,73,-5,959
"1642",46111,77,74,-3,959
"1643",46112,79,76,-3,959
"1644",46113,80,76,-4,959
"1645",46114,81,75,-6,959
"1646",46115,80,77,-3,959
"1647",46116,80,78,-2,959
"1648",46117,82,78,-4,959
"1649",46118,82,80,-2,959
"1650",46119,85,81,-4,959
"1651",46120,85,80,-5,959
"1652",46121,84,79,-5,959
"1653",46122,83,78,-5,959
"1654",46123,85,83,-2,959
"1655",46124,83,81,-2,959
"1656",46125,77,77,0,959
"1657",46128,12,13,1,959
"1658",46129,86,83,-3,959
"1659",46130,89,84,-5,959
"1660",46131,91,86,-5,959
"1661",46132,89,84,-5,959
"1662",46133,88,82,-6,959
"1663",46134,83,77,-6,959
"1664",46135,85,79,-6,959
"1665",46136,89,80,-9,959
"1666",46137,79,77,-2,959
"1667",46138,77,74,-3,959
"1668",46139,76,71,-5,959
"1669",46140,77,74,-3,959
"1670",46141,62,60,-2,959
"1671",46142,57,56,-1,959
"1672",46143,20,17,-3,959
"1673",46144,11,12,1,959
"1674",46145,7,7,0,959
"1675",46146,5,4,-1,959
"1676",46147,5,6,1,959
"1677",46148,5,6,1,959
"1678",46149,6,7,1,959
"1679",46150,6,7,1,959
"1680",46151,6,7,1,959
"1681",46152,5,6,1,959
"1682",46153,5,6,1,959
"1683",46154,6,6,0,959
"1684",46155,6,7,1,959
"1685",46156,7,8,1,959
"1686",46157,7,9,2,959
"1687",46158,8,9,1,959
"1688",46159,8,9,1,959
"1689",46160,8,9,1,959
"1690",46161,8,10,2,959
"1691",46162,9,12,3,959
"1692",46163,9,12,3,959
"1693",46164,52,51,-1,959
"1694",46165,67,65,-2,959
"1695",46166,68,67,-1,959
"1696",46167,94,91,-3,959
"1697",46168,94,91,-3,959
"1698",46169,89,84,-5,959
"1699",46170,94,88,-6,959
"1700",46171,93,88,-5,959
"1701",46172,91,85,-6,959
"1702",46173,92,88,-4,959
"1703",46174,89,86,-3,959
"1704",46175,7,7,0,959
"1705",46807,5,3,-2,959
"1706",46808,5,4,-1,959
"1707",46809,5,4,-1,959
"1708",46810,5,4,-1,959
"1709",46811,7,6,-1,959
"1710",46812,15,11,-4,959
"1711",46813,66,64,-2,959
"1712",46814,70,66,-4,959
"1713",46815,68,64,-4,959
"1714",46816,67,63,-4,959
"1715",46817,69,64,-5,959
"1716",46818,74,72,-2,959
"1717",46819,75,72,-3,959
"1718",46820,74,70,-4,959
"1719",46821,75,72,-3,959
"1720",46822,73,70,-3,959
"1721",46823,73,69,-4,959
"1722",46824,71,67,-4,959
"1723",46825,73,70,-3,959
"1724",46826,74,71,-3,959
"1725",46827,72,72,0,959
"1726",46828,75,71,-4,959
"1727",46829,80,74,-6,959
"1728",46830,80,75,-5,959
"1729",46831,79,76,-3,959
"1730",46832,81,75,-6,959
"1731",46833,81,75,-6,959
"1732",46834,80,75,-5,959
"1733",46835,78,77,-1,959
"1734",46836,80,77,-3,959
"1735",46837,83,78,-5,959
"1736",46838,85,80,-5,959
"1737",46839,84,80,-4,959
"1738",46840,86,80,-6,959
"1739",46841,84,79,-5,959
"1740",46842,84,80,-4,959
"1741",46843,84,84,0,959
"1742",46844,83,83,0,959
"1743",46845,12,15,3,959
"1744",46847,75,76,1,959
"1745",46848,91,84,-7,959
"1746",46849,92,87,-5,959
"1747",46850,72,66,-6,959
"1748",46851,90,86,-4,959
"1749",46852,84,81,-3,959
"1750",46853,83,80,-3,959
"1751",46854,85,81,-4,959
"1752",46855,86,80,-6,959
"1753",46856,86,79,-7,959
"1754",46857,82,77,-5,959
"1755",46858,85,78,-7,959
"1756",46859,77,76,-1,959
"1757",46860,64,64,0,959
"1758",46861,15,12,-3,959
"1759",46862,8,8,0,959
"1760",46863,7,7,0,959
"1761",46864,7,7,0,959
"1762",46865,5,5,0,959
"1763",46866,5,4,-1,959
"1764",46867,5,5,0,959
"1765",46868,5,6,1,959
"1766",46869,4,6,2,959
"1767",46870,5,7,2,959
"1768",46871,5,6,1,959
"1769",46872,5,6,1,959
"1770",46873,5,6,1,959
"1771",46874,5,6,1,959
"1772",46875,8,9,1,959
"1773",46876,8,9,1,959
"1774",46877,6,9,3,959
"1775",46878,8,9,1,959
"1776",46879,8,9,1,959
"1777",46880,8,9,1,959
"1778",46881,8,10,2,959
"1779",46882,7,10,3,959
"1780",46883,9,12,3,959
"1781",46884,9,12,3,959
"1782",46885,10,12,2,959
"1783",46886,10,12,2,959
"1784",46887,18,20,2,959
"1785",46888,83,82,-1,959
"1786",46889,90,88,-2,959
"1787",46890,91,87,-4,959
"1788",46891,98,94,-4,959
"1789",46892,99,94,-5,959
"1790",46893,98,95,-3,959
"1791",46894,98,95,-3,959
"1792",46895,90,88,-2,959
"1793",47527,3,3,0,959
"1794",47528,4,3,-1,959
"1795",47529,4,4,0,959
"1796",47530,5,4,-1,959
"1797",47531,7,6,-1,959
"1798",47532,7,6,-1,959
"1799",47533,22,22,0,959
"1800",47534,54,51,-3,959
"1801",47535,71,64,-7,959
"1802",47536,72,63,-9,959
"1803",47537,72,68,-4,959
"1804",47538,69,65,-4,959
"1805",47539,71,69,-2,959
"1806",47540,73,70,-3,959
"1807",47541,80,76,-4,959
"1808",47542,82,79,-3,959
"1809",47543,79,72,-7,959
"1810",47544,77,69,-8,959
"1811",47545,74,70,-4,959
"1812",47546,74,72,-2,959
"1813",47547,78,73,-5,959
"1814",47548,78,75,-3,959
"1815",47549,78,77,-1,959
"1816",47550,77,78,1,959
"1817",47551,78,78,0,959
"1818",47552,79,79,0,959
"1819",47553,81,77,-4,959
"1820",47554,80,76,-4,959
"1821",47555,81,78,-3,959
"1822",47556,78,80,2,959
"1823",47557,84,84,0,959
"1824",47558,85,83,-2,959
"1825",47559,84,82,-2,959
"1826",47560,87,84,-3,959
"1827",47561,86,83,-3,959
"1828",47562,87,82,-5,959
"1829",47563,85,82,-3,959
"1830",47564,54,54,0,959
"1831",47565,91,87,-4,959
"1832",47566,92,88,-4,959
"1833",47567,89,87,-2,959
"1834",47568,83,79,-4,959
"1835",47569,82,79,-3,959
"1836",47570,88,82,-6,959
"1837",47571,89,85,-4,959
"1838",47572,88,85,-3,959
"1839",47573,87,84,-3,959
"1840",47574,89,85,-4,959
"1841",47575,84,78,-6,959
"1842",47576,89,83,-6,959
"1843",47577,86,81,-5,959
"1844",47578,58,55,-3,959
"1845",47579,17,13,-4,959
"1846",47580,9,8,-1,959
"1847",47581,8,8,0,959
"1848",47582,7,7,0,959
"1849",47583,5,5,0,959
"1850",47584,5,5,0,959
"1851",47585,5,5,0,959
"1852",47586,4,4,0,959
"1853",47587,6,7,1,959
"1854",47588,6,7,1,959
"1855",47589,6,7,1,959
"1856",47590,4,5,1,959
"1857",47591,5,5,0,959
"1858",47592,5,5,0,959
"1859",47593,5,5,0,959
"1860",47594,7,7,0,959
"1861",47595,8,7,-1,959
"1862",47596,8,8,0,959
"1863",47597,6,7,1,959
"1864",47598,7,7,0,959
"1865",47599,7,10,3,959
"1866",47600,7,10,3,959
"1867",47601,7,10,3,959
"1868",47602,7,10,3,959
"1869",47603,7,10,3,959
"1870",47604,9,12,3,959
"1871",47605,9,12,3,959
"1872",47606,9,12,3,959
"1873",47607,10,12,2,959
"1874",47608,67,66,-1,959
"1875",47609,102,96,-6,959
"1876",47610,95,90,-5,959
"1877",47611,101,98,-3,959
"1878",47612,103,98,-5,959
"1879",47613,83,81,-2,959
"1880",47614,94,90,-4,959
"1881",47615,97,95,-2,959
"1882",47616,96,95,-1,959
"1883",48248,3,3,0,959
"1884",48249,3,3,0,959
"1885",48250,3,3,0,959
"1886",48251,4,3,-1,959
"1887",48252,4,3,-1,959
"1888",48253,5,5,0,959
"1889",48254,7,7,0,959
"1890",48255,14,12,-2,959
"1891",48256,14,13,-1,959
"1892",48257,28,30,2,959
"1893",48258,68,67,-1,959
"1894",48259,76,71,-5,959
"1895",48260,82,79,-3,959
"1896",48261,84,79,-5,959
"1897",48262,76,73,-3,959
"1898",48263,75,66,-9,959
"1899",48264,71,63,-8,959
"1900",48265,72,70,-2,959
"1901",48266,74,71,-3,959
"1902",48267,77,77,0,959
"1903",48268,79,79,0,959
"1904",48269,79,80,1,959
"1905",48270,78,79,1,959
"1906",48271,78,80,2,959
"1907",48272,79,79,0,959
"1908",48273,80,78,-2,959
"1909",48274,78,78,0,959
"1910",48275,80,78,-2,959
"1911",48276,83,80,-3,959
"1912",48277,86,84,-2,959
"1913",48278,88,87,-1,959
"1914",48279,89,89,0,959
"1915",48280,88,87,-1,959
"1916",48283,53,54,1,959
"1917",48284,94,89,-5,959
"1918",48285,95,90,-5,959
"1919",48286,95,90,-5,959
"1920",48287,91,89,-2,959
"1921",48288,82,79,-3,959
"1922",48289,86,83,-3,959
"1923",48290,87,85,-2,959
"1924",48291,94,89,-5,959
"1925",48292,95,90,-5,959
"1926",48293,88,82,-6,959
"1927",48294,91,84,-7,959
"1928",48295,82,80,-2,959
"1929",48296,67,65,-2,959
"1930",48297,13,13,0,959
"1931",48298,7,7,0,959
"1932",48299,5,5,0,959
"1933",48300,6,6,0,959
"1934",48301,6,6,0,959
"1935",48302,5,5,0,959
"1936",48303,5,5,0,959
"1937",48304,5,5,0,959
"1938",48305,4,5,1,959
"1939",48306,4,4,0,959
"1940",48307,4,5,1,959
"1941",48308,6,7,1,959
"1942",48309,6,7,1,959
"1943",48310,7,7,0,959
"1944",48311,7,7,0,959
"1945",48312,7,7,0,959
"1946",48313,7,7,0,959
"1947",48314,7,7,0,959
"1948",48316,12,12,0,959
"1949",48317,9,8,-1,959
"1950",48318,7,6,-1,959
"1951",48319,7,8,1,959
"1952",48320,7,8,1,959
"1953",48321,6,8,2,959
"1954",48322,6,10,4,959
"1955",48323,8,12,4,959
"1956",48324,8,12,4,959
"1957",48325,8,12,4,959
"1958",48326,9,12,3,959
"1959",48327,10,12,2,959
"1960",48328,11,12,1,959
"1961",48329,79,76,-3,959
"1962",48330,94,91,-3,959
"1963",48331,104,103,-1,959
"1964",48332,106,103,-3,959
"1965",48333,101,98,-3,959
"1966",48334,102,98,-4,959
"1967",48335,101,96,-5,959
"1968",48336,98,96,-2,959
"1969",48337,91,90,-1,959
"1970",48338,40,46,6,959
"1971",48948,2,3,1,959
"1972",48949,2,3,1,959
"1973",48950,2,3,1,959
"1974",48951,2,3,1,959
"1975",48952,2,3,1,959
"1976",48968,3,3,0,959
"1977",48969,3,3,0,959
"1978",48970,3,3,0,959
"1979",48971,3,3,0,959
"1980",48972,3,3,0,959
"1981",48973,3,4,1,959
"1982",48974,4,4,0,959
"1983",48975,4,4,0,959
"1984",48976,4,4,0,959
"1985",48977,6,6,0,959
"1986",48978,8,7,-1,959
"1987",48979,8,7,-1,959
"1988",48980,14,14,0,959
"1989",48981,14,14,0,959
"1990",48982,13,13,0,959
"1991",48983,66,63,-3,959
"1992",48984,67,63,-4,959
"1993",48985,75,75,0,959
"1994",48986,73,71,-2,959
"1995",48987,78,77,-1,959
"1996",48988,79,77,-2,959
"1997",48989,79,78,-1,959
"1998",48990,79,78,-1,959
"1999",48991,81,79,-2,959
"2000",48992,81,80,-1,959
"2001",48993,80,80,0,959
"2002",48994,85,84,-1,959
"2003",48995,89,85,-4,959
"2004",48996,91,85,-6,959
"2005",48997,81,82,1,959
"2006",48998,83,83,0,959
"2007",48999,92,87,-5,959
"2008",49000,94,91,-3,959
"2009",49001,97,91,-6,959
"2010",49002,98,92,-6,959
"2011",49003,96,94,-2,959
"2012",49004,98,94,-4,959
"2013",49005,93,89,-4,959
"2014",49006,93,86,-7,959
"2015",49007,90,85,-5,959
"2016",49008,79,78,-1,959
"2017",49009,96,90,-6,959
"2018",49010,97,93,-4,959
"2019",49011,84,83,-1,959
"2020",49012,70,68,-2,959
"2021",49013,61,59,-2,959
"2022",49014,50,51,1,959
"2023",49015,8,8,0,959
"2024",49016,6,7,1,959
"2025",49017,5,5,0,959
"2026",49018,5,5,0,959
"2027",49019,5,5,0,959
"2028",49020,6,6,0,959
"2029",49021,5,5,0,959
"2030",49022,5,5,0,959
"2031",49023,5,4,-1,959
"2032",49024,4,4,0,959
"2033",49025,4,4,0,959
"2034",49026,4,4,0,959
"2035",49027,4,5,1,959
"2036",49037,11,10,-1,959
"2037",49038,6,6,0,959
"2038",49039,6,7,1,959
"2039",49040,7,8,1,959
"2040",49041,7,8,1,959
"2041",49042,7,8,1,959
"2042",49043,8,9,1,959
"2043",49044,8,9,1,959
"2044",49045,8,9,1,959
"2045",49046,8,10,2,959
"2046",49047,9,10,1,959
"2047",49048,9,12,3,959
"2048",49049,16,18,2,959
"2049",49050,76,76,0,959
"2050",49051,104,104,0,959
"2051",49052,102,100,-2,959
"2052",49053,99,99,0,959
"2053",49054,94,92,-2,959
"2054",49055,92,92,0,959
"2055",49056,101,99,-2,959
"2056",49057,102,99,-3,959
"2057",49058,99,98,-1,959
"2058",49059,99,98,-1,959
"2059",49060,48,54,6,959
"2060",49666,2,3,1,959
"2061",49667,2,3,1,959
"2062",49668,2,3,1,959
"2063",49669,2,3,1,959
"2064",49670,2,3,1,959
"2065",49671,2,3,1,959
"2066",49672,2,3,1,959
"2067",49673,3,3,0,959
"2068",49674,3,3,0,959
"2069",49675,3,3,0,959
"2070",49676,3,3,0,959
"2071",49681,1,2,1,959
"2072",49682,2,3,1,959
"2073",49683,2,3,1,959
"2074",49684,2,3,1,959
"2075",49685,2,3,1,959
"2076",49686,2,3,1,959
"2077",49687,3,3,0,959
"2078",49688,3,3,0,959
"2079",49689,3,3,0,959
"2080",49690,3,3,0,959
"2081",49691,3,3,0,959
"2082",49692,3,3,0,959
"2083",49693,3,4,1,959
"2084",49694,4,4,0,959
"2085",49695,4,4,0,959
"2086",49696,5,4,-1,959
"2087",49697,5,4,-1,959
"2088",49698,6,6,0,959
"2089",49699,6,6,0,959
"2090",49700,6,6,0,959
"2091",49701,6,6,0,959
"2092",49702,6,6,0,959
"2093",49703,11,10,-1,959
"2094",49704,54,53,-1,959
"2095",49705,71,70,-1,959
"2096",49706,73,69,-4,959
"2097",49707,76,75,-1,959
"2098",49708,76,76,0,959
"2099",49709,79,78,-1,959
"2100",49710,79,78,-1,959
"2101",49711,81,79,-2,959
"2102",49712,92,90,-2,959
"2103",49713,93,88,-5,959
"2104",49714,92,87,-5,959
"2105",49715,85,82,-3,959
"2106",49716,88,86,-2,959
"2107",49717,93,89,-4,959
"2108",49718,95,90,-5,959
"2109",49719,95,94,-1,959
"2110",49720,96,92,-4,959
"2111",49721,98,92,-6,959
"2112",49722,98,92,-6,959
"2113",49723,97,94,-3,959
"2114",49724,86,81,-5,959
"2115",49725,88,81,-7,959
"2116",49726,90,83,-7,959
"2117",49727,84,81,-3,959
"2118",49728,74,73,-1,959
"2119",49729,69,66,-3,959
"2120",49730,20,21,1,959
"2121",49731,12,13,1,959
"2122",49732,11,13,2,959
"2123",49733,6,7,1,959
"2124",49734,5,6,1,959
"2125",49735,6,6,0,959
"2126",49736,6,7,1,959
"2127",49737,5,6,1,959
"2128",49738,5,5,0,959
"2129",49739,5,5,0,959
"2130",49740,5,4,-1,959
"2131",49741,5,4,-1,959
"2132",49742,5,4,-1,959
"2133",49743,5,4,-1,959
"2134",49744,4,4,0,959
"2135",49745,4,4,0,959
"2136",49746,4,5,1,959
"2137",49758,8,8,0,959
"2138",49759,6,7,1,959
"2139",49760,8,10,2,959
"2140",49761,8,10,2,959
"2141",49762,7,8,1,959
"2142",49763,8,9,1,959
"2143",49764,8,9,1,959
"2144",49765,8,9,1,959
"2145",49766,8,9,1,959
"2146",49767,8,9,1,959
"2147",49768,8,11,3,959
"2148",49769,10,12,2,959
"2149",49770,18,20,2,959
"2150",49771,77,74,-3,959
"2151",49772,98,98,0,959
"2152",49773,102,103,1,959
"2153",49774,100,100,0,959
"2154",49775,84,85,1,959
"2155",49776,100,98,-2,959
"2156",49777,100,99,-1,959
"2157",49778,101,101,0,959
"2158",49779,97,97,0,959
"2159",49780,96,98,2,959
"2160",49781,93,94,1,959
"2161",50385,2,3,1,959
"2162",50386,2,3,1,959
"2163",50387,2,3,1,959
"2164",50388,2,3,1,959
"2165",50389,2,3,1,959
"2166",50390,2,3,1,959
"2167",50391,2,3,1,959
"2168",50392,2,3,1,959
"2169",50393,3,4,1,959
"2170",50394,4,4,0,959
"2171",50395,4,4,0,959
"2172",50396,4,4,0,959
"2173",50397,4,4,0,959
"2174",50398,4,4,0,959
"2175",50399,1,3,2,959
"2176",50400,1,2,1,959
"2177",50401,1,2,1,959
"2178",50402,2,3,1,959
"2179",50403,2,3,1,959
"2180",50404,2,3,1,959
"2181",50405,2,3,1,959
"2182",50406,2,3,1,959
"2183",50407,2,2,0,959
"2184",50408,2,2,0,959
"2185",50409,1,1,0,959
"2186",50410,1,1,0,959
"2187",50411,1,1,0,959
"2188",50412,1,1,0,959
"2189",50413,1,2,1,959
"2190",50414,2,2,0,959
"2191",50415,4,3,-1,959
"2192",50416,4,4,0,959
"2193",50417,4,4,0,959
"2194",50418,4,4,0,959
"2195",50419,7,6,-1,959
"2196",50420,7,6,-1,959
"2197",50421,7,6,-1,959
"2198",50422,10,9,-1,959
"2199",50423,12,10,-2,959
"2200",50424,13,10,-3,959
"2201",50425,36,36,0,959
"2202",50426,69,68,-1,959
"2203",50427,76,74,-2,959
"2204",50428,82,79,-3,959
"2205",50429,83,81,-2,959
"2206",50430,84,83,-1,959
"2207",50431,91,88,-3,959
"2208",50432,90,88,-2,959
"2209",50433,93,89,-4,959
"2210",50434,95,91,-4,959
"2211",50435,95,90,-5,959
"2212",50436,95,91,-4,959
"2213",50437,96,93,-3,959
"2214",50438,97,94,-3,959
"2215",50439,97,95,-2,959
"2216",50440,97,92,-5,959
"2217",50441,100,95,-5,959
"2218",50442,100,95,-5,959
"2219",50443,99,96,-3,959
"2220",50444,87,84,-3,959
"2221",50445,71,68,-3,959
"2222",50446,69,67,-2,959
"2223",50447,18,16,-2,959
"2224",50448,15,14,-1,959
"2225",50449,9,8,-1,959
"2226",50450,5,6,1,959
"2227",50451,5,6,1,959
"2228",50452,6,6,0,959
"2229",50453,6,7,1,959
"2230",50454,5,6,1,959
"2231",50455,5,6,1,959
"2232",50456,5,7,2,959
"2233",50457,5,6,1,959
"2234",50458,7,7,0,959
"2235",50459,10,10,0,959
"2236",50460,9,9,0,959
"2237",50461,6,6,0,959
"2238",50462,6,6,0,959
"2239",50463,4,4,0,959
"2240",50464,4,4,0,959
"2241",50479,6,6,0,959
"2242",50480,6,7,1,959
"2243",50481,6,8,2,959
"2244",50482,8,10,2,959
"2245",50483,7,10,3,959
"2246",50484,7,10,3,959
"2247",50485,8,9,1,959
"2248",50486,12,12,0,959
"2249",50487,12,13,1,959
"2250",50488,9,12,3,959
"2251",50489,10,13,3,959
"2252",50490,10,13,3,959
"2253",50491,17,20,3,959
"2254",50492,80,80,0,959
"2255",50493,109,110,1,959
"2256",50494,108,106,-2,959
"2257",50495,106,106,0,959
"2258",50496,106,105,-1,959
"2259",50497,107,105,-2,959
"2260",50498,107,107,0,959
"2261",50499,103,104,1,959
"2262",50500,102,101,-1,959
"2263",51103,2,3,1,959
"2264",51104,2,3,1,959
"2265",51105,2,3,1,959
"2266",51106,2,3,1,959
"2267",51107,2,3,1,959
"2268",51108,2,3,1,959
"2269",51109,2,3,1,959
"2270",51110,2,3,1,959
"2271",51111,2,3,1,959
"2272",51112,2,3,1,959
"2273",51113,9,10,1,959
"2274",51114,9,10,1,959
"2275",51115,4,4,0,959
"2276",51116,4,4,0,959
"2277",51117,10,10,0,959
"2278",51118,15,15,0,959
"2279",51119,14,15,1,959
"2280",51120,1,2,1,959
"2281",51121,1,2,1,959
"2282",51122,2,3,1,959
"2283",51123,2,3,1,959
"2284",51124,2,3,1,959
"2285",51125,2,3,1,959
"2286",51126,2,3,1,959
"2287",51127,2,2,0,959
"2288",51128,2,2,0,959
"2289",51129,1,1,0,959
"2290",51130,1,2,1,959
"2291",51131,1,2,1,959
"2292",51132,1,2,1,959
"2293",51133,2,2,0,959
"2294",51134,2,3,1,959
"2295",51135,4,4,0,959
"2296",51136,4,4,0,959
"2297",51137,4,5,1,959
"2298",51138,6,7,1,959
"2299",51139,7,7,0,959
"2300",51140,7,7,0,959
"2301",51141,7,7,0,959
"2302",51142,7,7,0,959
"2303",51143,14,13,-1,959
"2304",51144,15,12,-3,959
"2305",51145,24,19,-5,959
"2306",51146,34,32,-2,959
"2307",51147,99,95,-4,959
"2308",51148,98,94,-4,959
"2309",51149,99,94,-5,959
"2310",51150,96,91,-5,959
"2311",51151,92,89,-3,959
"2312",51152,89,87,-2,959
"2313",51153,81,81,0,959
"2314",51154,94,93,-1,959
"2315",51155,101,99,-2,959
"2316",51156,102,99,-3,959
"2317",51157,94,90,-4,959
"2318",51158,89,86,-3,959
"2319",51159,86,84,-2,959
"2320",51160,89,87,-2,959
"2321",51161,90,86,-4,959
"2322",51162,80,76,-4,959
"2323",51163,27,28,1,959
"2324",51164,12,11,-1,959
"2325",51165,9,8,-1,959
"2326",51166,8,7,-1,959
"2327",51167,6,5,-1,959
"2328",51168,5,5,0,959
"2329",51169,5,5,0,959
"2330",51170,5,6,1,959
"2331",51171,5,6,1,959
"2332",51172,5,6,1,959
"2333",51173,6,6,0,959
"2334",51174,5,6,1,959
"2335",51175,5,6,1,959
"2336",51176,5,6,1,959
"2337",51177,5,6,1,959
"2338",51178,5,5,0,959
"2339",51179,6,6,0,959
"2340",51180,6,6,0,959
"2341",51181,6,6,0,959
"2342",51182,6,6,0,959
"2343",51201,6,8,2,959
"2344",51202,6,8,2,959
"2345",51203,5,8,3,959
"2346",51204,5,8,3,959
"2347",51205,7,9,2,959
"2348",51206,8,10,2,959
"2349",51207,10,11,1,959
"2350",51208,10,12,2,959
"2351",51209,10,13,3,959
"2352",51210,10,13,3,959
"2353",51211,10,14,4,959
"2354",51212,20,24,4,959
"2355",51213,77,75,-2,959
"2356",51214,108,108,0,959
"2357",51215,106,107,1,959
"2358",51216,106,106,0,959
"2359",51217,106,106,0,959
"2360",51822,2,4,2,959
"2361",51823,3,4,1,959
"2362",51824,3,4,1,959
"2363",51825,3,4,1,959
"2364",51826,3,4,1,959
"2365",51827,3,4,1,959
"2366",51828,2,3,1,959
"2367",51829,2,3,1,959
"2368",51830,2,3,1,959
"2369",51831,2,3,1,959
"2370",51832,2,3,1,959
"2371",51833,2,3,1,959
"2372",51834,2,3,1,959
"2373",51835,3,3,0,959
"2374",51836,3,3,0,959
"2375",51837,3,3,0,959
"2376",51838,4,4,0,959
"2377",51839,4,4,0,959
"2378",51840,1,2,1,959
"2379",51841,1,2,1,959
"2380",51842,2,3,1,959
"2381",51843,2,3,1,959
"2382",51844,2,2,0,959
"2383",51845,1,1,0,959
"2384",51846,2,2,0,959
"2385",51847,2,2,0,959
"2386",51848,2,2,0,959
"2387",51849,3,2,-1,959
"2388",51850,3,2,-1,959
"2389",51851,3,2,-1,959
"2390",51852,3,2,-1,959
"2391",51853,3,2,-1,959
"2392",51854,3,2,-1,959
"2393",51855,2,3,1,959
"2394",51856,4,5,1,959
"2395",51857,5,5,0,959
"2396",51858,5,5,0,959
"2397",51859,5,5,0,959
"2398",51860,5,5,0,959
"2399",51861,8,6,-2,959
"2400",51862,13,10,-3,959
"2401",51863,21,18,-3,959
"2402",51864,93,91,-2,959
"2403",51865,96,93,-3,959
"2404",51866,96,94,-2,959
"2405",51867,89,88,-1,959
"2406",51868,92,91,-1,959
"2407",51869,93,89,-4,959
"2408",51870,91,88,-3,959
"2409",51871,93,91,-2,959
"2410",51872,93,91,-2,959
"2411",51873,87,86,-1,959
"2412",51874,85,85,0,959
"2413",51875,19,17,-2,959
"2414",51876,13,12,-1,959
"2415",51877,14,13,-1,959
"2416",51878,14,13,-1,959
"2417",51879,8,7,-1,959
"2418",51880,9,7,-2,959
"2419",51881,6,6,0,959
"2420",51882,6,6,0,959
"2421",51883,6,6,0,959
"2422",51884,5,5,0,959
"2423",51885,5,5,0,959
"2424",51886,5,5,0,959
"2425",51887,5,5,0,959
"2426",51888,5,5,0,959
"2427",51889,5,5,0,959
"2428",51890,5,6,1,959
"2429",51891,5,6,1,959
"2430",51892,5,6,1,959
"2431",51893,5,6,1,959
"2432",51894,5,6,1,959
"2433",51895,5,6,1,959
"2434",51896,5,6,1,959
"2435",51897,4,5,1,959
"2436",51898,4,5,1,959
"2437",51899,4,4,0,959
"2438",51900,4,4,0,959
"2439",51922,6,8,2,959
"2440",51923,5,8,3,959
"2441",51924,5,8,3,959
"2442",51925,6,8,2,959
"2443",51926,9,11,2,959
"2444",51927,13,15,2,959
"2445",51928,15,16,1,959
"2446",51929,15,17,2,959
"2447",52541,4,4,0,959
"2448",52542,4,4,0,959
"2449",52543,4,4,0,959
"2450",52544,4,4,0,959
"2451",52545,4,4,0,959
"2452",52546,4,4,0,959
"2453",52547,4,4,0,959
"2454",52548,2,3,1,959
"2455",52549,2,3,1,959
"2456",52550,2,3,1,959
"2457",52551,2,3,1,959
"2458",52552,2,3,1,959
"2459",52553,3,3,0,959
"2460",52554,3,3,0,959
"2461",52555,3,3,0,959
"2462",52556,3,3,0,959
"2463",52557,3,3,0,959
"2464",52558,3,3,0,959
"2465",52559,3,3,0,959
"2466",52560,1,2,1,959
"2467",52561,1,2,1,959
"2468",52562,3,4,1,959
"2469",52563,3,3,0,959
"2470",52564,3,3,0,959
"2471",52565,2,2,0,959
"2472",52566,2,2,0,959
"2473",52567,2,2,0,959
"2474",52568,2,2,0,959
"2475",52569,3,2,-1,959
"2476",52570,3,2,-1,959
"2477",52571,3,2,-1,959
"2478",52572,3,2,-1,959
"2479",52573,6,4,-2,959
"2480",52574,6,4,-2,959
"2481",52575,5,4,-1,959
"2482",52576,6,5,-1,959
"2483",52577,11,10,-1,959
"2484",52578,19,17,-2,959
"2485",52579,19,17,-2,959
"2486",52580,66,65,-1,959
"2487",52581,67,64,-3,959
"2488",52582,64,61,-3,959
"2489",52583,88,85,-3,959
"2490",52584,90,88,-2,959
"2491",52585,95,91,-4,959
"2492",52586,96,93,-3,959
"2493",52587,98,97,-1,959
"2494",52588,96,95,-1,959
"2495",52589,66,66,0,959
"2496",52590,14,14,0,959
"2497",52591,8,8,0,959
"2498",52592,7,8,1,959
"2499",52593,7,7,0,959
"2500",52594,5,5,0,959
"2501",52595,4,4,0,959
"2502",52596,4,4,0,959
"2503",52597,5,5,0,959
"2504",52598,5,5,0,959
"2505",52599,5,5,0,959
"2506",52600,5,5,0,959
"2507",52601,6,6,0,959
"2508",52602,5,5,0,959
"2509",52603,5,5,0,959
"2510",52604,5,5,0,959
"2511",52605,5,5,0,959
"2512",52606,5,5,0,959
"2513",52607,5,5,0,959
"2514",52608,5,5,0,959
"2515",52609,5,5,0,959
"2516",52610,5,5,0,959
"2517",52611,5,6,1,959
"2518",52612,5,6,1,959
"2519",52613,5,6,1,959
"2520",52614,4,5,1,959
"2521",52615,3,4,1,959
"2522",52616,3,4,1,959
"2523",52617,3,4,1,959
"2524",52618,4,5,1,959
"2525",52643,5,8,3,959
"2526",53259,3,3,0,959
"2527",53260,3,3,0,959
"2528",53261,4,4,0,959
"2529",53262,26,25,-1,959
"2530",53263,26,25,-1,959
"2531",53264,21,23,2,959
"2532",53265,21,22,1,959
"2533",53266,24,25,1,959
"2534",53267,25,25,0,959
"2535",53268,2,3,1,959
"2536",53269,2,3,1,959
"2537",53270,2,3,1,959
"2538",53271,2,3,1,959
"2539",53272,3,3,0,959
"2540",53273,3,3,0,959
"2541",53274,3,3,0,959
"2542",53275,4,3,-1,959
"2543",53276,4,3,-1,959
"2544",53277,3,3,0,959
"2545",53278,3,3,0,959
"2546",53279,3,3,0,959
"2547",53280,1,2,1,959
"2548",53281,2,4,2,959
"2549",53282,4,6,2,959
"2550",53283,3,2,-1,959
"2551",53284,3,2,-1,959
"2552",53285,2,2,0,959
"2553",53286,2,2,0,959
"2554",53287,2,2,0,959
"2555",53288,2,2,0,959
"2556",53289,2,2,0,959
"2557",53290,2,2,0,959
"2558",53291,6,5,-1,959
"2559",53292,11,10,-1,959
"2560",53293,55,55,0,959
"2561",53294,55,55,0,959
"2562",53295,30,30,0,959
"2563",53296,59,58,-1,959
"2564",53297,59,58,-1,959
"2565",53298,86,82,-4,959
"2566",53299,87,85,-2,959
"2567",53300,87,84,-3,959
"2568",53301,85,82,-3,959
"2569",53302,89,85,-4,959
"2570",53303,89,88,-1,959
"2571",53304,87,86,-1,959
"2572",53305,25,25,0,959
"2573",53306,23,22,-1,959
"2574",53307,9,9,0,959
"2575",53308,5,6,1,959
"2576",53309,5,6,1,959
"2577",53310,5,6,1,959
"2578",53311,5,6,1,959
"2579",53312,5,6,1,959
"2580",53313,5,6,1,959
"2581",53314,5,6,1,959
"2582",53315,5,6,1,959
"2583",53316,5,5,0,959
"2584",53317,5,5,0,959
"2585",53318,5,5,0,959
"2586",53319,5,5,0,959
"2587",53320,4,5,1,959
"2588",53321,5,5,0,959
"2589",53322,5,5,0,959
"2590",53323,5,5,0,959
"2591",53324,5,5,0,959
"2592",53325,5,5,0,959
"2593",53326,5,5,0,959
"2594",53327,5,5,0,959
"2595",53328,4,4,0,959
"2596",53329,4,4,0,959
"2597",53330,4,4,0,959
"2598",53331,4,4,0,959
"2599",53332,3,4,1,959
"2600",53333,3,4,1,959
"2601",53334,3,4,1,959
"2602",53335,3,4,1,959
"2603",53336,3,4,1,959
"2604",53978,3,3,0,959
"2605",53979,3,3,0,959
"2606",53980,3,3,0,959
"2607",53981,4,4,0,959
"2608",53982,14,14,0,959
"2609",53983,14,14,0,959
"2610",53984,7,7,0,959
"2611",53985,26,26,0,959
"2612",53986,25,24,-1,959
"2613",53987,24,24,0,959
"2614",53988,23,24,1,959
"2615",53989,23,22,-1,959
"2616",53990,18,20,2,959
"2617",53991,15,17,2,959
"2618",53992,5,6,1,959
"2619",53993,2,3,1,959
"2620",53994,2,3,1,959
"2621",53995,2,3,1,959
"2622",53996,3,3,0,959
"2623",53997,3,4,1,959
"2624",53998,3,4,1,959
"2625",53999,4,3,-1,959
"2626",54000,3,4,1,959
"2627",54001,1,2,1,959
"2628",54002,3,4,1,959
"2629",54003,3,2,-1,959
"2630",54004,3,2,-1,959
"2631",54005,2,2,0,959
"2632",54006,4,3,-1,959
"2633",54007,29,27,-2,959
"2634",54008,28,26,-2,959
"2635",54009,29,27,-2,959
"2636",54010,29,27,-2,959
"2637",54011,80,79,-1,959
"2638",54012,81,80,-1,959
"2639",54013,82,81,-1,959
"2640",54014,82,82,0,959
"2641",54015,82,82,0,959
"2642",54016,82,79,-3,959
"2643",54017,73,72,-1,959
"2644",54018,73,75,2,959
"2645",54019,72,71,-1,959
"2646",54020,63,63,0,959
"2647",54021,60,61,1,959
"2648",54022,35,35,0,959
"2649",54023,9,9,0,959
"2650",54024,7,8,1,959
"2651",54025,5,6,1,959
"2652",54026,5,6,1,959
"2653",54027,5,6,1,959
"2654",54028,5,6,1,959
"2655",54029,5,6,1,959
"2656",54030,5,6,1,959
"2657",54031,5,6,1,959
"2658",54032,5,6,1,959
"2659",54033,5,6,1,959
"2660",54034,5,5,0,959
"2661",54035,4,4,0,959
"2662",54036,4,5,1,959
"2663",54037,4,5,1,959
"2664",54038,4,5,1,959
"2665",54039,4,6,2,959
"2666",54040,4,6,2,959
"2667",54041,5,6,1,959
"2668",54042,5,6,1,959
"2669",54043,5,6,1,959
"2670",54044,5,6,1,959
"2671",54045,4,6,2,959
"2672",54046,4,5,1,959
"2673",54047,4,5,1,959
"2674",54048,4,4,0,959
"2675",54049,3,4,1,959
"2676",54050,3,4,1,959
"2677",54051,3,4,1,959
"2678",54052,3,4,1,959
"2679",54697,3,3,0,959
"2680",54698,3,3,0,959
"2681",54699,3,3,0,959
"2682",54700,3,3,0,959
"2683",54701,3,3,0,959
"2684",54702,3,3,0,959
"2685",54703,3,3,0,959
"2686",54704,3,3,0,959
"2687",54705,5,4,-1,959
"2688",54706,8,7,-1,959
"2689",54707,25,24,-1,959
"2690",54708,24,24,0,959
"2691",54709,20,22,2,959
"2692",54710,17,19,2,959
"2693",54711,20,23,3,959
"2694",54712,20,23,3,959
"2695",54713,21,24,3,959
"2696",54714,22,24,2,959
"2697",54715,22,24,2,959
"2698",54716,21,24,3,959
"2699",54717,21,23,2,959
"2700",54718,24,26,2,959
"2701",54719,26,26,0,959
"2702",54720,3,5,2,959
"2703",54721,0,2,2,959
"2704",54722,27,24,-3,959
"2705",54723,27,23,-4,959
"2706",54724,27,23,-4,959
"2707",54725,46,33,-13,959
"2708",54726,50,39,-11,959
"2709",54727,61,53,-8,959
"2710",54728,63,55,-8,959
"2711",54729,68,62,-6,959
"2712",54730,70,65,-5,959
"2713",54731,81,80,-1,959
"2714",54732,82,81,-1,959
"2715",54733,75,73,-2,959
"2716",54734,79,77,-2,959
"2717",54735,79,77,-2,959
"2718",54736,64,63,-1,959
"2719",54737,63,64,1,959
"2720",54738,6,7,1,959
"2721",54739,3,5,2,959
"2722",54740,3,5,2,959
"2723",54741,4,4,0,959
"2724",54742,4,4,0,959
"2725",54743,6,7,1,959
"2726",54744,6,7,1,959
"2727",54745,6,7,1,959
"2728",54746,6,7,1,959
"2729",54747,5,7,2,959
"2730",54748,5,7,2,959
"2731",54749,5,7,2,959
"2732",54750,5,7,2,959
"2733",54751,5,6,1,959
"2734",54752,5,6,1,959
"2735",54753,5,6,1,959
"2736",54754,5,6,1,959
"2737",54755,5,5,0,959
"2738",54756,4,5,1,959
"2739",54757,4,5,1,959
"2740",54758,4,5,1,959
"2741",54759,4,6,2,959
"2742",54760,4,6,2,959
"2743",54761,4,6,2,959
"2744",54762,5,6,1,959
"2745",54763,5,5,0,959
"2746",54764,5,5,0,959
"2747",54765,5,5,0,959
"2748",54766,5,5,0,959
"2749",54767,4,5,1,959
"2750",54768,4,5,1,959
"2751",55416,4,4,0,959
"2752",55417,4,4,0,959
"2753",55418,4,4,0,959
"2754",55419,4,4,0,959
"2755",55420,4,4,0,959
"2756",55421,3,4,1,959
"2757",55422,3,4,1,959
"2758",55423,3,4,1,959
"2759",55424,3,4,1,959
"2760",55425,4,5,1,959
"2761",55426,4,5,1,959
"2762",55427,4,5,1,959
"2763",55428,4,6,2,959
"2764",55429,4,6,2,959
"2765",55430,9,11,2,959
"2766",55431,20,23,3,959
"2767",55432,22,25,3,959
"2768",55433,22,25,3,959
"2769",55434,22,24,2,959
"2770",55435,21,24,3,959
"2771",55436,21,24,3,959
"2772",55437,21,24,3,959
"2773",55438,23,24,1,959
"2774",55439,24,24,0,959
"2775",55440,2,5,3,959
"2776",55441,4,4,0,959
"2777",55442,26,23,-3,959
"2778",55443,30,25,-5,959
"2779",55444,30,25,-5,959
"2780",55445,12,10,-2,959
"2781",55446,11,6,-5,959
"2782",55447,12,10,-2,959
"2783",55448,12,9,-3,959
"2784",55449,7,6,-1,959
"2785",55450,5,5,0,959
"2786",55451,3,3,0,959
"2787",55452,3,3,0,959
"2788",55453,4,3,-1,959
"2789",55454,4,3,-1,959
"2790",55455,4,3,-1,959
"2791",55456,4,3,-1,959
"2792",55457,3,4,1,959
"2793",55458,3,4,1,959
"2794",55459,3,5,2,959
"2795",55460,3,5,2,959
"2796",55461,4,4,0,959
"2797",55462,4,4,0,959
"2798",55463,5,7,2,959
"2799",55464,5,7,2,959
"2800",55465,5,6,1,959
"2801",55466,5,6,1,959
"2802",55467,5,6,1,959
"2803",55468,5,6,1,959
"2804",55469,5,6,1,959
"2805",55470,5,6,1,959
"2806",55471,4,6,2,959
"2807",55472,4,6,2,959
"2808",55473,4,6,2,959
"2809",55474,4,5,1,959
"2810",55475,4,5,1,959
"2811",55476,4,5,1,959
"2812",55477,4,5,1,959
"2813",55478,4,5,1,959
"2814",55479,4,6,2,959
"2815",55480,4,6,2,959
"2816",55481,4,5,1,959
"2817",55482,4,5,1,959
"2818",55483,4,5,1,959
"2819",55484,4,5,1,959
"2820",56136,4,4,0,959
"2821",56137,4,4,0,959
"2822",56138,4,4,0,959
"2823",56139,4,4,0,959
"2824",56140,4,4,0,959
"2825",56141,3,4,1,959
"2826",56142,3,4,1,959
"2827",56143,3,4,1,959
"2828",56144,3,4,1,959
"2829",56145,4,4,0,959
"2830",56146,4,4,0,959
"2831",56147,3,5,2,959
"2832",56148,3,5,2,959
"2833",56149,3,5,2,959
"2834",56150,3,5,2,959
"2835",56151,3,4,1,959
"2836",56152,3,4,1,959
"2837",56153,3,4,1,959
"2838",56154,3,4,1,959
"2839",56155,3,5,2,959
"2840",56156,3,5,2,959
"2841",56157,14,15,1,959
"2842",56158,23,25,2,959
"2843",56159,22,23,1,959
"2844",56160,2,4,2,959
"2845",56162,3,3,0,959
"2846",56163,4,3,-1,959
"2847",56164,4,3,-1,959
"2848",56165,4,3,-1,959
"2849",56166,4,3,-1,959
"2850",56167,4,3,-1,959
"2851",56168,4,3,-1,959
"2852",56169,4,3,-1,959
"2853",56170,4,3,-1,959
"2854",56171,5,4,-1,959
"2855",56172,5,4,-1,959
"2856",56173,5,4,-1,959
"2857",56174,5,4,-1,959
"2858",56175,5,4,-1,959
"2859",56176,5,4,-1,959
"2860",56177,5,4,-1,959
"2861",56178,5,5,0,959
"2862",56179,5,5,0,959
"2863",56180,5,6,1,959
"2864",56181,5,6,1,959
"2865",56182,4,7,3,959
"2866",56183,5,6,1,959
"2867",56184,5,6,1,959
"2868",56185,4,6,2,959
"2869",56186,4,6,2,959
"2870",56187,4,6,2,959
"2871",56188,4,6,2,959
"2872",56189,4,6,2,959
"2873",56190,4,6,2,959
"2874",56191,4,6,2,959
"2875",56192,4,6,2,959
"2876",56193,4,5,1,959
"2877",56194,4,5,1,959
"2878",56195,4,6,2,959
"2879",56196,4,5,1,959
"2880",56197,4,5,1,959
"2881",56857,4,4,0,959
"2882",56858,4,4,0,959
"2883",56859,4,4,0,959
"2884",56860,4,4,0,959
"2885",56861,3,4,1,959
"2886",56862,3,4,1,959
"2887",56863,3,4,1,959
"2888",56864,3,4,1,959
"2889",56865,2,3,1,959
"2890",56866,3,4,1,959
"2891",56867,3,3,0,959
"2892",56868,3,3,0,959
"2893",56869,3,3,0,959
"2894",56870,3,3,0,959
"2895",56871,3,3,0,959
"2896",56872,3,3,0,959
"2897",56873,3,3,0,959
"2898",56874,3,3,0,959
"2899",56875,3,4,1,959
"2900",56876,3,4,1,959
"2901",56877,3,4,1,959
"2902",56878,3,4,1,959
"2903",56879,3,4,1,959
"2904",56880,0,1,1,959
"2905",56882,3,3,0,959
"2906",56883,4,3,-1,959
"2907",56884,4,3,-1,959
"2908",56885,3,3,0,959
"2909",56886,3,3,0,959
"2910",56887,3,3,0,959
"2911",56888,3,3,0,959
"2912",56889,3,3,0,959
"2913",56890,3,3,0,959
"2914",56891,4,4,0,959
"2915",56892,4,4,0,959
"2916",56893,4,4,0,959
"2917",56894,4,4,0,959
"2918",56895,4,4,0,959
"2919",56896,4,4,0,959
"2920",56897,4,4,0,959
"2921",56898,4,5,1,959
"2922",56899,4,4,0,959
"2923",56900,4,4,0,959
"2924",56901,4,4,0,959
"2925",56902,4,5,1,959
"2926",56903,4,5,1,959
"2927",56904,4,6,2,959
"2928",56905,4,6,2,959
"2929",56906,4,6,2,959
"2930",56907,4,6,2,959
"2931",56908,4,6,2,959
"2932",56909,4,6,2,959
"2933",56910,4,5,1,959
"2934",56911,4,5,1,959
"2935",56912,4,4,0,959
"2936",57578,4,4,0,959
"2937",57579,4,4,0,959
"2938",57580,4,4,0,959
"2939",57581,3,4,1,959
"2940",57582,3,4,1,959
"2941",57583,3,4,1,959
"2942",57584,3,4,1,959
"2943",57585,2,3,1,959
"2944",57586,2,3,1,959
"2945",57587,2,2,0,959
"2946",57588,2,2,0,959
"2947",57589,2,2,0,959
"2948",57590,2,2,0,959
"2949",57591,2,3,1,959
"2950",57592,3,3,0,959
"2951",57593,3,3,0,959
"2952",57594,3,3,0,959
"2953",57595,3,4,1,959
"2954",57596,3,4,1,959
"2955",57597,3,4,1,959
"2956",57598,3,4,1,959
"2957",57599,3,4,1,959
"2958",57600,0,1,1,959
"2959",57601,1,1,0,959
"2960",57602,3,4,1,959
"2961",57603,3,4,1,959
"2962",57604,3,4,1,959
"2963",57605,3,3,0,959
"2964",57606,3,3,0,959
"2965",57607,3,3,0,959
"2966",57608,3,3,0,959
"2967",57609,4,3,-1,959
"2968",57610,4,3,-1,959
"2969",57611,4,3,-1,959
"2970",57612,4,3,-1,959
"2971",57613,4,3,-1,959
"2972",57614,4,3,-1,959
"2973",57615,4,3,-1,959
"2974",57616,4,3,-1,959
"2975",57617,4,3,-1,959
"2976",57618,4,4,0,959
"2977",57619,4,4,0,959
"2978",57620,4,4,0,959
"2979",57621,4,4,0,959
"2980",57622,4,4,0,959
"2981",57623,4,5,1,959
"2982",57624,4,5,1,959
"2983",57625,4,4,0,959
"2984",57626,5,4,-1,959
"2985",57627,5,4,-1,959
"2986",57628,5,4,-1,959
"2987",58300,4,4,0,959
"2988",58301,3,3,0,959
"2989",58302,3,3,0,959
"2990",58303,2,3,1,959
"2991",58304,2,3,1,959
"2992",58305,2,2,0,959
"2993",58306,2,2,0,959
"2994",58307,3,2,-1,959
"2995",58308,3,2,-1,959
"2996",58309,3,2,-1,959
"2997",58310,3,2,-1,959
"2998",58311,3,2,-1,959
"2999",58312,3,2,-1,959
"3000",58313,3,2,-1,959
"3001",58314,3,2,-1,959
"3002",58315,3,2,-1,959
"3003",58316,4,2,-2,959
"3004",58317,4,3,-1,959
"3005",58318,4,3,-1,959
"3006",58319,4,4,0,959
"3007",58320,1,1,0,959
"3008",58321,1,1,0,959
"3009",58322,3,3,0,959
"3010",58323,3,3,0,959
"3011",58324,3,3,0,959
"3012",58325,3,3,0,959
"3013",58326,3,3,0,959
"3014",58327,3,3,0,959
"3015",58328,3,3,0,959
"3016",58329,4,3,-1,959
"3017",58330,4,3,-1,959
"3018",58331,4,3,-1,959
"3019",58332,4,3,-1,959
"3020",58333,4,3,-1,959
"3021",58334,4,3,-1,959
"3022",58335,4,3,-1,959
"3023",58336,4,3,-1,959
"3024",58337,4,3,-1,959
"3025",58338,4,3,-1,959
"3026",58339,4,4,0,959
"3027",58340,4,4,0,959
"3028",58341,4,4,0,959
"3029",58342,4,4,0,959
"3030",58343,4,4,0,959
"3031",58344,5,4,-1,959
"3032",59022,3,3,0,959
"3033",59023,2,3,1,959
"3034",59024,2,3,1,959
"3035",59025,2,2,0,959
"3036",59026,2,2,0,959
"3037",59027,3,2,-1,959
"3038",59028,3,2,-1,959
"3039",59029,3,2,-1,959
"3040",59030,3,2,-1,959
"3041",59031,3,2,-1,959
"3042",59032,3,2,-1,959
"3043",59033,3,2,-1,959
"3044",59034,3,2,-1,959
"3045",59035,3,2,-1,959
"3046",59036,3,2,-1,959
"3047",59037,3,2,-1,959
"3048",59038,3,2,-1,959
"3049",59039,3,3,0,959
"3050",59040,1,1,0,959
"3051",59041,2,1,-1,959
"3052",59042,4,3,-1,959
"3053",59043,4,3,-1,959
"3054",59044,4,3,-1,959
"3055",59045,4,3,-1,959
"3056",59046,4,3,-1,959
"3057",59047,4,3,-1,959
"3058",59048,4,3,-1,959
"3059",59049,4,3,-1,959
"3060",59050,4,3,-1,959
"3061",59051,4,3,-1,959
"3062",59052,4,3,-1,959
"3063",59053,4,3,-1,959
"3064",59054,4,3,-1,959
"3065",59055,4,3,-1,959
"3066",59056,4,3,-1,959
"3067",59057,4,3,-1,959
"3068",59058,4,3,-1,959
"3069",59059,5,3,-2,959
"3070",59750,3,2,-1,959
"3071",59751,3,2,-1,959
"3072",59752,3,2,-1,959
"3073",59753,3,2,-1,959
"3074",59754,3,2,-1,959
"3075",59755,3,2,-1,959
"3076",59756,3,2,-1,959
"3077",59757,3,3,0,959
"3078",59758,3,3,0,959
"3079",59759,3,3,0,959
"3080",59760,1,1,0,959
"3081",59761,2,1,-1,959
"3082",59762,5,3,-2,959
"3083",59763,5,3,-2,959
"3084",59764,5,3,-2,959
"3085",59765,5,3,-2,959
"3086",59766,5,3,-2,959
"3087",59767,5,3,-2,959
"3088",59768,5,3,-2,959
"3089",59769,5,3,-2,959
"3090",59770,5,3,-2,959
"3091",59771,5,3,-2,959
"3092",60474,3,2,-1,959
"3093",60475,3,2,-1,959
"3094",60476,3,3,0,959
"3095",60477,3,3,0,959
"3096",60478,3,3,0,959
"3097",60479,3,3,0,959
"3098",60480,1,1,0,959
"3099",60481,2,1,-1,959
"3100",60482,5,4,-1,959
"3101",60483,5,4,-1,959
"3102",60484,5,4,-1,959
"3103",60485,5,4,-1,959
"3104",61200,2,1,-1,959
"3105",49060,48,54,6,925
"3106",49061,8,10,2,925
"3107",49780,96,98,2,925
"3108",49781,93,94,1,925
"3109",50494,108,106,-2,925
"3110",50494,108,106,-2,925
"3111",50495,106,106,0,925
"3112",50496,106,105,-1,925
"3113",50497,107,105,-2,925
"3114",50497,107,105,-2,925
"3115",50498,107,107,0,925
"3116",50498,107,107,0,925
"3117",50499,103,104,1,925
"3118",50499,103,104,1,925
"3119",50500,102,101,-1,925
"3120",50501,48,51,3,925
"3121",51209,10,13,3,925
"3122",51210,10,13,3,925
"3123",51211,10,14,4,925
"3124",51212,20,24,4,925
"3125",51213,77,75,-2,925
"3126",51214,108,108,0,925
"3127",51214,108,108,0,925
"3128",51215,106,107,1,925
"3129",51215,106,107,1,925
"3130",51216,106,106,0,925
"3131",51216,106,106,0,925
"3132",51217,106,106,0,925
"3133",51217,106,106,0,925
"3134",51218,106,107,1,925
"3135",51219,104,104,0,925
"3136",51220,101,100,-1,925
"3137",51221,91,92,1,925
"3138",51923,5,8,3,925
"3139",51924,5,8,3,925
"3140",51925,6,8,2,925
"3141",51926,9,11,2,925
"3142",51927,13,15,2,925
"3143",51928,15,16,1,925
"3144",51929,15,17,2,925
"3145",51930,10,13,3,925
"3146",51931,10,13,3,925
"3147",51932,12,15,3,925
"3148",51933,46,49,3,925
"3149",51934,108,106,-2,925
"3150",51935,103,102,-1,925
"3151",51936,101,100,-1,925
"3152",51937,101,102,1,925
"3153",51938,101,102,1,925
"3154",51939,104,104,0,925
"3155",51940,104,105,1,925
"3156",51941,92,93,1,925
"3157",51942,104,103,-1,925
"3158",51943,104,103,-1,925
"3159",51944,27,29,2,925
"3160",52643,5,8,3,925
"3161",52644,6,9,3,925
"3162",52645,6,9,3,925
"3163",52646,7,9,2,925
"3164",52647,9,11,2,925
"3165",52648,14,16,2,925
"3166",52649,15,17,2,925
"3167",52650,15,17,2,925
"3168",52651,12,15,3,925
"3169",52652,13,16,3,925
"3170",52653,13,16,3,925
"3171",52654,70,72,2,925
"3172",52655,109,107,-2,925
"3173",52656,105,104,-1,925
"3174",52657,106,106,0,925
"3175",52658,99,99,0,925
"3176",52659,106,106,0,925
"3177",52660,106,107,1,925
"3178",52661,107,106,-1,925
"3179",52662,107,106,-1,925
"3180",52663,60,61,1,925
"3181",52664,51,52,1,925
"3182",53363,6,9,3,925
"3183",53364,6,9,3,925
"3184",53365,6,9,3,925
"3185",53366,7,9,2,925
"3186",53367,7,9,2,925
"3187",53368,7,9,2,925
"3188",53369,7,9,2,925
"3189",53370,10,12,2,925
"3190",53371,10,12,2,925
"3191",53372,11,13,2,925
"3192",53373,11,14,3,925
"3193",53374,12,15,3,925
"3194",53375,20,22,2,925
"3195",53376,106,107,1,925
"3196",53377,109,110,1,925
"3197",53378,105,106,1,925
"3198",53379,101,100,-1,925
"3199",53380,93,93,0,925
"3200",53381,110,108,-2,925
"3201",53382,109,107,-2,925
"3202",53383,104,103,-1,925
"3203",53384,105,101,-4,925
"3204",53385,29,31,2,925
"3205",53386,28,29,1,925
"3206",54084,6,10,4,925
"3207",54085,6,9,3,925
"3208",54086,7,9,2,925
"3209",54087,7,9,2,925
"3210",54088,7,9,2,925
"3211",54089,7,9,2,925
"3212",54090,7,10,3,925
"3213",54091,10,12,2,925
"3214",54092,16,17,1,925
"3215",54093,16,18,2,925
"3216",54094,11,14,3,925
"3217",54095,12,15,3,925
"3218",54096,15,18,3,925
"3219",54097,108,109,1,925
"3220",54098,110,112,2,925
"3221",54099,109,110,1,925
"3222",54100,88,89,1,925
"3223",54101,95,93,-2,925
"3224",54102,109,108,-1,925
"3225",54103,109,106,-3,925
"3226",54104,107,105,-2,925
"3227",54105,106,105,-1,925
"3228",54106,59,63,4,925
"3229",54805,8,10,2,925
"3230",54806,8,10,2,925
"3231",54807,8,10,2,925
"3232",54808,8,10,2,925
"3233",54809,8,10,2,925
"3234",54810,8,10,2,925
"3235",54811,8,11,3,925
"3236",54812,11,13,2,925
"3237",54813,12,13,1,925
"3238",54814,12,14,2,925
"3239",54815,12,14,2,925
"3240",54816,13,17,4,925
"3241",54817,14,18,4,925
"3242",54818,112,113,1,925
"3243",54819,113,115,2,925
"3244",54820,91,91,0,925
"3245",54821,99,97,-2,925
"3246",54822,106,105,-1,925
"3247",54823,106,105,-1,925
"3248",54824,109,107,-2,925
"3249",54825,108,108,0,925
"3250",54826,54,61,7,925
"3251",55526,8,10,2,925
"3252",55527,8,10,2,925
"3253",55528,8,10,2,925
"3254",55529,8,10,2,925
"3255",55530,10,12,2,925
"3256",55531,10,12,2,925
"3257",55532,10,13,3,925
"3258",55533,11,13,2,925
"3259",55534,12,13,1,925
"3260",55535,12,13,1,925
"3261",55536,12,15,3,925
"3262",55537,13,16,3,925
"3263",55538,13,16,3,925
"3264",55539,14,17,3,925
"3265",55540,44,44,0,925
"3266",55541,90,87,-3,925
"3267",55542,105,103,-2,925
"3268",55543,104,103,-1,925
"3269",55544,109,110,1,925
"3270",55545,108,106,-2,925
"3271",55546,92,93,1,925
"3272",55547,47,52,5,925
"3273",56247,8,10,2,925
"3274",56248,8,10,2,925
"3275",56249,8,10,2,925
"3276",56250,8,10,2,925
"3277",56251,8,10,2,925
"3278",56252,8,10,2,925
"3279",56253,8,11,3,925
"3280",56254,9,11,2,925
"3281",56255,12,14,2,925
"3282",56256,12,14,2,925
"3283",56257,13,15,2,925
"3284",56258,17,20,3,925
"3285",56259,17,20,3,925
"3286",56260,19,20,1,925
"3287",56261,68,69,1,925
"3288",56262,94,89,-5,925
"3289",56263,116,114,-2,925
"3290",56264,110,112,2,925
"3291",56265,112,108,-4,925
"3292",56266,112,106,-6,925
"3293",56267,108,104,-4,925
"3294",56268,101,100,-1,925
"3295",56269,57,55,-2,925
"3296",56270,49,53,4,925
"3297",56271,48,52,4,925
"3298",56968,8,10,2,925
"3299",56969,8,10,2,925
"3300",56970,8,10,2,925
"3301",56971,8,10,2,925
"3302",56972,10,12,2,925
"3303",56973,10,13,3,925
"3304",56974,10,13,3,925
"3305",56975,11,14,3,925
"3306",56976,12,14,2,925
"3307",56977,13,14,1,925
"3308",56978,13,15,2,925
"3309",56979,15,17,2,925
"3310",56980,16,18,2,925
"3311",56981,15,17,2,925
"3312",56982,16,18,2,925
"3313",56983,28,29,1,925
"3314",56984,117,115,-2,925
"3315",56985,116,113,-3,925
"3316",56986,101,99,-2,925
"3317",56988,36,32,-4,925
"3318",56989,98,100,2,925
"3319",56990,110,108,-2,925
"3320",56991,110,108,-2,925
"3321",56992,14,16,2,925
"3322",56993,12,14,2,925
"3323",57690,10,12,2,925
"3324",57691,10,12,2,925
"3325",57692,10,13,3,925
"3326",57693,10,12,2,925
"3327",57694,13,15,2,925
"3328",57695,13,16,3,925
"3329",57696,12,14,2,925
"3330",57697,14,14,0,925
"3331",57698,13,13,0,925
"3332",57699,14,14,0,925
"3333",57700,15,15,0,925
"3334",57701,15,17,2,925
"3335",57702,16,18,2,925
"3336",57703,19,20,1,925
"3337",57704,24,25,1,925
"3338",57705,104,103,-1,925
"3339",57706,114,112,-2,925
"3340",57707,106,105,-1,925
"3341",57708,46,47,1,925
"3342",57710,110,110,0,925
"3343",57711,113,117,4,925
"3344",57712,114,117,3,925
"3345",57713,103,102,-1,925
"3346",57714,52,52,0,925
"3347",58411,10,13,3,925
"3348",58412,10,13,3,925
"3349",58413,10,12,2,925
"3350",58414,10,12,2,925
"3351",58415,10,13,3,925
"3352",58416,11,13,2,925
"3353",58417,12,13,1,925
"3354",58418,14,14,0,925
"3355",58419,14,14,0,925
"3356",58420,15,14,-1,925
"3357",58421,14,15,1,925
"3358",58422,14,15,1,925
"3359",58423,15,16,1,925
"3360",58424,15,16,1,925
"3361",58425,20,20,0,925
"3362",58426,89,91,2,925
"3363",58427,113,113,0,925
"3364",58428,107,109,2,925
"3365",58429,105,105,0,925
"3366",58430,56,54,-2,925
"3367",58431,110,109,-1,925
"3368",58432,113,117,4,925
"3369",58433,116,117,1,925
"3370",58434,115,115,0,925
"3371",58435,87,85,-2,925
"3372",59133,14,16,2,925
"3373",59134,14,16,2,925
"3374",59135,10,15,5,925
"3375",59136,10,14,4,925
"3376",59137,11,14,3,925
"3377",59138,12,14,2,925
"3378",59139,14,15,1,925
"3379",59140,15,15,0,925
"3380",59141,15,15,0,925
"3381",59142,14,14,0,925
"3382",59143,15,14,-1,925
"3383",59144,15,15,0,925
"3384",59145,15,16,1,925
"3385",59146,19,20,1,925
"3386",59147,63,65,2,925
"3387",59148,105,109,4,925
"3388",59149,118,118,0,925
"3389",59150,118,116,-2,925
"3390",59151,118,118,0,925
"3391",59151,118,118,0,925
"3392",59152,110,111,1,925
"3393",59153,103,102,-1,925
"3394",59154,115,117,2,925
"3395",59855,13,18,5,925
"3396",59856,10,15,5,925
"3397",59857,10,14,4,925
"3398",59858,12,14,2,925
"3399",59859,12,14,2,925
"3400",59860,14,15,1,925
"3401",59861,15,15,0,925
"3402",59862,15,15,0,925
"3403",59863,16,15,-1,925
"3404",59864,15,14,-1,925
"3405",59865,15,15,0,925
"3406",59866,15,15,0,925
"3407",59867,19,18,-1,925
"3408",59868,74,73,-1,925
"3409",59868,74,73,-1,925
"3410",59869,102,101,-1,925
"3411",59869,102,101,-1,925
"3412",59870,108,107,-1,925
"3413",59870,108,107,-1,925
"3414",59871,123,121,-2,925
"3415",59871,123,121,-2,925
"3416",59872,120,121,1,925
"3417",59873,116,118,2,925
"3418",59874,116,117,1,925
"3419",60577,8,12,4,925
"3420",60578,10,13,3,925
"3421",60579,12,13,1,925
"3422",60580,12,13,1,925
"3423",60581,14,13,-1,925
"3424",60582,13,12,-1,925
"3425",60583,12,13,1,925
"3426",60584,14,13,-1,925
"3427",60585,14,14,0,925
"3428",60586,15,15,0,925
"3429",60586,15,15,0,925
"3430",60587,15,15,0,925
"3431",60587,15,15,0,925
"3432",60588,21,21,0,925
"3433",60588,21,21,0,925
"3434",60589,70,72,2,925
"3435",60590,98,98,0,925
"3436",61298,8,12,4,925
"3437",61299,10,12,2,925
"3438",61300,10,12,2,925
"3439",61301,13,12,-1,925
"3440",61302,13,12,-1,925
"3441",61303,12,13,1,925
"3442",61304,12,13,1,925
"3443",61304,12,13,1,925
"3444",61305,13,14,1,925
"3445",61305,13,14,1,925
"3446",61306,15,15,0,925
"3447",61306,15,15,0,925
"3448",61307,15,15,0,925
"3449",61308,17,17,0,925
"3450",62020,11,13,2,925
"3451",62021,11,13,2,925
"3452",62022,11,13,2,925
"3453",62022,11,13,2,925
"3454",62023,12,13,1,925
"3455",62023,12,13,1,925
"3456",62024,12,13,1,925
"3457",62024,12,13,1,925
"3458",62025,12,13,1,925
"3459",59151,118,118,0,848
"3460",59154,115,117,2,848
"3461",59155,114,114,0,848
"3462",59156,95,94,-1,848
"3463",59868,74,73,-1,848
"3464",59869,102,101,-1,848
"3465",59870,108,107,-1,848
"3466",59871,123,121,-2,848
"3467",59872,120,121,1,848
"3468",59873,116,118,2,848
"3469",59874,116,117,1,848
"3470",59875,114,112,-2,848
"3471",59876,110,108,-2,848
"3472",60586,15,15,0,848
"3473",60587,15,15,0,848
"3474",60588,21,21,0,848
"3475",60589,70,72,2,848
"3476",60590,98,98,0,848
"3477",60591,125,126,1,848
"3478",60592,111,111,0,848
"3479",60595,113,112,-1,848
"3480",60596,112,110,-2,848
"3481",61304,12,13,1,848
"3482",61305,13,14,1,848
"3483",61306,15,15,0,848
"3484",61307,15,15,0,848
"3485",61308,17,17,0,848
"3486",61309,21,21,0,848
"3487",61310,42,41,-1,848
"3488",61311,126,127,1,848
"3489",61312,120,119,-1,848
"3490",61314,0,0,0,848
"3491",61316,0,0,0,848
"3492",62022,11,13,2,848
"3493",62023,12,13,1,848
"3494",62024,12,13,1,848
"3495",62025,12,13,1,848
"3496",62026,15,14,-1,848
"3497",62027,14,13,-1,848
"3498",62028,14,13,-1,848
"3499",62029,16,15,-1,848
"3500",62030,35,34,-1,848
"3501",62031,116,117,1,848
"3502",62032,125,126,1,848
"3503",62033,118,118,0,848
"3504",62742,11,13,2,848
"3505",62743,11,13,2,848
"3506",62744,11,13,2,848
"3507",62745,13,13,0,848
"3508",62746,14,14,0,848
"3509",62747,13,13,0,848
"3510",62748,14,13,-1,848
"3511",62749,16,15,-1,848
"3512",62750,23,23,0,848
"3513",62751,103,101,-2,848
"3514",62752,130,130,0,848
"3515",62753,120,121,1,848
"3516",63463,11,13,2,848
"3517",63464,11,13,2,848
"3518",63465,12,13,1,848
"3519",63466,14,14,0,848
"3520",63467,15,14,-1,848
"3521",63468,16,14,-2,848
"3522",63469,17,16,-1,848
"3523",63470,31,30,-1,848
"3524",63471,104,103,-1,848
"3525",63472,125,122,-3,848
"3526",63473,115,113,-2,848
"3527",64183,11,13,2,848
"3528",64184,11,13,2,848
"3529",64185,12,14,2,848
"3530",64186,13,14,1,848
"3531",64187,13,14,1,848
"3532",64188,16,14,-2,848
"3533",64189,16,15,-1,848
"3534",64190,22,21,-1,848
"3535",64191,69,68,-1,848
"3536",64192,121,119,-2,848
"3537",64193,113,112,-1,848
"3538",64903,9,11,2,848
"3539",64904,10,11,1,848
"3540",64905,10,12,2,848
"3541",64906,11,12,1,848
"3542",64907,13,14,1,848
"3543",64908,15,14,-1,848
"3544",64909,16,14,-2,848
"3545",64910,40,38,-2,848
"3546",64911,102,100,-2,848
"3547",64912,99,97,-2,848
"3548",65623,11,12,1,848
"3549",65624,11,11,0,848
"3550",65625,12,12,0,848
"3551",65626,12,12,0,848
"3552",65627,15,14,-1,848
"3553",65628,16,14,-2,848
"3554",65629,17,14,-3,848
"3555",65630,32,30,-2,848
"3556",65631,108,102,-6,848
"3557",65632,101,97,-4,848
"3558",66342,13,13,0,848
"3559",66343,13,13,0,848
"3560",66344,14,13,-1,848
"3561",66345,14,14,0,848
"3562",66346,14,14,0,848
"3563",66347,14,13,-1,848
"3564",66348,15,13,-2,848
"3565",66349,17,15,-2,848
"3566",66350,24,23,-1,848
"3567",66351,96,92,-4,848
"3568",66352,90,87,-3,848
"3569",67062,13,13,0,848
"3570",67063,14,13,-1,848
"3571",67064,14,13,-1,848
"3572",67065,15,15,0,848
"3573",67066,16,15,-1,848
"3574",67067,15,14,-1,848
"3575",67068,15,13,-2,848
"3576",67069,17,15,-2,848
"3577",67070,24,22,-2,848
"3578",67071,103,96,-7,848
"3579",67072,93,90,-3,848
"3580",67782,11,11,0,848
"3581",67783,12,11,-1,848
"3582",67784,15,14,-1,848
"3583",67785,17,15,-2,848
"3584",67786,16,15,-1,848
"3585",67787,16,15,-1,848
"3586",67788,17,15,-2,848
"3587",67789,17,15,-2,848
"3588",67790,23,21,-2,848
"3589",67791,117,111,-6,848
"3590",67792,108,104,-4,848
"3591",68502,11,11,0,848
"3592",68503,12,11,-1,848
"3593",68504,15,13,-2,848
"3594",68505,16,14,-2,848
"3595",68506,16,14,-2,848
"3596",68507,16,15,-1,848
"3597",68508,17,15,-2,848
"3598",68509,17,15,-2,848
"3599",68510,23,21,-2,848
"3600",68511,106,96,-10,848
"3601",68512,99,90,-9,848
"3602",69222,13,12,-1,848
"3603",69223,11,10,-1,848
"3604",69224,12,10,-2,848
"3605",69225,15,14,-1,848
"3606",69226,17,15,-2,848
"3607",69227,17,16,-1,848
"3608",69228,17,15,-2,848
"3609",69229,18,14,-4,848
"3610",69230,24,20,-4,848
"3611",69231,78,69,-9,848
"3612",69232,77,68,-9,848
"3613",69943,14,12,-2,848
"3614",69944,14,12,-2,848
"3615",69945,16,15,-1,848
"3616",69946,17,15,-2,848
"3617",69947,16,15,-1,848
"3618",69948,16,15,-1,848
"3619",69949,17,14,-3,848
"3620",69950,18,14,-4,848
"3621",69951,111,104,-7,848
"3622",69952,109,103,-6,848
"3623",70663,14,12,-2,848
"3624",70664,14,12,-2,848
"3625",70665,15,13,-2,848
"3626",70666,15,13,-2,848
"3627",70667,15,13,-2,848
"3628",70668,13,12,-1,848
"3629",70669,17,15,-2,848
"3630",70670,20,18,-2,848
"3631",70671,103,97,-6,848
"3632",70672,103,97,-6,848
"3633",71383,14,12,-2,848
"3634",71384,14,12,-2,848
"3635",71385,16,14,-2,848
"3636",71386,16,14,-2,848
"3637",71387,16,14,-2,848
"3638",71388,16,15,-1,848
"3639",71389,18,17,-1,848
"3640",71390,21,20,-1,848
"3641",71391,99,93,-6,848
"3642",71392,98,93,-5,848
"3643",72103,13,10,-3,848
"3644",72104,13,10,-3,848
"3645",72105,13,10,-3,848
"3646",72106,14,11,-3,848
"3647",72107,14,11,-3,848
"3648",72108,14,11,-3,848
"3649",72109,15,11,-4,848
"3650",72110,22,17,-5,848
"3651",72111,32,30,-2,848
"3652",72112,109,99,-10,848
"3653",72113,104,95,-9,848
"3654",72823,13,10,-3,848
"3655",72824,13,10,-3,848
"3656",72825,13,10,-3,848
"3657",72826,14,11,-3,848
"3658",72827,14,11,-3,848
"3659",72828,15,11,-4,848
"3660",72829,15,11,-4,848
"3661",72830,18,13,-5,848
"3662",72831,20,16,-4,848
"3663",72832,45,36,-9,848
"3664",72833,44,36,-8,848
"3665",73544,12,9,-3,848
"3666",73545,13,10,-3,848
"3667",73546,14,11,-3,848
"3668",73547,15,11,-4,848
"3669",73548,15,11,-4,848
"3670",73549,15,12,-3,848
"3671",73550,16,12,-4,848
"3672",73551,16,12,-4,848
"3673",73552,35,29,-6,848
"3674",73553,127,111,-16,848
"3675",73554,120,105,-15,848
"3676",74264,12,10,-2,848
"3677",74265,13,10,-3,848
"3678",74266,13,11,-2,848
"3679",74267,15,11,-4,848
"3680",74268,15,11,-4,848
"3681",74269,15,12,-3,848
"3682",74270,16,12,-4,848
"3683",74271,16,12,-4,848
"3684",74272,16,12,-4,848
"3685",74273,87,76,-11,848
"3686",74274,130,121,-9,848
"3687",74275,113,105,-8,848
"3688",74276,108,97,-11,848
"3689",74985,13,10,-3,848
"3690",74986,13,10,-3,848
"3691",74987,15,11,-4,848
"3692",74988,15,12,-3,848
"3693",74989,15,12,-3,848
"3694",74990,16,12,-4,848
"3695",74991,16,12,-4,848
"3696",74992,16,12,-4,848
"3697",74993,18,14,-4,848
"3698",74994,128,115,-13,848
"3699",74995,141,128,-13,848
"3700",74996,132,122,-10,848
"3701",75705,13,9,-4,848
"3702",75706,13,9,-4,848
"3703",75707,15,10,-5,848
"3704",75708,15,12,-3,848
"3705",75709,15,12,-3,848
"3706",75710,16,12,-4,848
"3707",75711,16,12,-4,848
"3708",75712,16,12,-4,848
"3709",75713,18,12,-6,848
"3710",75714,33,23,-10,848
"3711",75715,130,117,-13,848
"3712",75716,124,111,-13,848
"3713",76426,13,10,-3,848
"3714",76427,13,10,-3,848
"3715",76428,15,11,-4,848
"3716",76429,15,12,-3,848
"3717",76430,16,12,-4,848
"3718",76431,15,11,-4,848
"3719",76432,15,11,-4,848
"3720",76433,17,10,-7,848
"3721",76434,20,12,-8,848
"3722",76435,45,33,-12,848
"3723",76436,135,124,-11,848
"3724",76437,128,116,-12,848
"3725",77147,13,10,-3,848
"3726",77148,14,11,-3,848
"3727",77149,14,11,-3,848
"3728",77150,14,11,-3,848
"3729",77151,15,11,-4,848
"3730",77152,15,11,-4,848
"3731",77153,18,10,-8,848
"3732",77154,18,10,-8,848
"3733",77155,21,12,-9,848
"3734",77156,82,65,-17,848
"3735",77157,81,66,-15,848
"3736",77867,12,10,-2,848
"3737",77868,12,10,-2,848
"3738",77869,15,10,-5,848
"3739",77870,15,10,-5,848
"3740",77871,16,10,-6,848
"3741",77872,18,10,-8,848
"3742",77873,19,10,-9,848
"3743",77874,19,10,-9,848
"3744",77875,20,13,-7,848
"3745",77876,29,20,-9,848
"3746",77877,60,51,-9,848
"3747",77878,58,50,-8,848
"3748",78588,13,10,-3,848
"3749",78589,14,9,-5,848
"3750",78590,15,10,-5,848
"3751",78591,16,10,-6,848
"3752",78592,18,10,-8,848
"3753",78593,18,10,-8,848
"3754",78594,19,10,-9,848
"3755",78595,18,11,-7,848
"3756",78596,20,13,-7,848
"3757",78597,86,73,-13,848
"3758",78598,114,99,-15,848
"3759",78599,112,94,-18,848
"3760",79309,16,10,-6,848
"3761",79310,16,10,-6,848
"3762",79311,17,11,-6,848
"3763",79312,17,11,-6,848
"3764",79313,18,12,-6,848
"3765",79314,18,12,-6,848
"3766",79315,18,13,-5,848
"3767",79316,18,13,-5,848
"3768",79317,65,52,-13,848
"3769",79318,91,77,-14,848
"3770",79319,89,72,-17,848
"3771",80030,15,10,-5,848
"3772",80031,15,10,-5,848
"3773",80032,17,11,-6,848
"3774",80033,18,12,-6,848
"3775",80034,18,12,-6,848
"3776",80035,18,13,-5,848
"3777",80036,18,13,-5,848
"3778",80037,18,13,-5,848
"3779",80038,40,30,-10,848
"3780",80039,120,104,-16,848
"3781",80040,169,149,-20,848
"3782",80041,165,151,-14,848
"3783",80042,155,145,-10,848
"3784",80043,145,133,-12,848
"3785",80751,15,12,-3,848
"3786",80752,16,12,-4,848
"3787",80753,17,13,-4,848
"3788",80754,18,13,-5,848
"3789",80755,18,13,-5,848
"3790",80756,18,13,-5,848
"3791",80757,18,13,-5,848
"3792",80758,21,14,-7,848
"3793",80759,33,27,-6,848
"3794",80760,157,145,-12,848
"3795",80761,165,153,-12,848
"3796",80762,154,137,-17,848
"3797",80763,164,150,-14,848
"3798",80764,159,154,-5,848
"3799",80765,153,144,-9,848
"3800",81472,16,12,-4,848
"3801",81473,16,12,-4,848
"3802",81474,18,13,-5,848
"3803",81475,18,13,-5,848
"3804",81476,18,13,-5,848
"3805",81477,17,13,-4,848
"3806",81478,19,14,-5,848
"3807",81479,26,19,-7,848
"3808",81480,43,36,-7,848
"3809",81481,167,154,-13,848
"3810",81482,167,154,-13,848
"3811",81483,166,154,-12,848
"3812",81484,164,154,-10,848
"3813",81485,162,155,-7,848
"3814",81486,145,138,-7,848
"3815",82192,16,12,-4,848
"3816",82193,15,12,-3,848
"3817",82194,15,12,-3,848
"3818",82195,17,13,-4,848
"3819",82196,17,13,-4,848
"3820",82197,17,13,-4,848
"3821",82198,19,14,-5,848
"3822",82199,20,13,-7,848
"3823",82200,37,29,-8,848
"3824",82201,81,62,-19,848
"3825",82202,142,129,-13,848
"3826",82203,168,158,-10,848
"3827",82204,167,158,-9,848
"3828",82205,83,74,-9,848
"3829",82206,80,74,-6,848
"3830",82913,15,12,-3,848
"3831",82914,15,12,-3,848
"3832",82915,15,12,-3,848
"3833",82916,16,13,-3,848
"3834",82917,16,13,-3,848
"3835",82918,18,13,-5,848
"3836",82919,18,12,-6,848
"3837",82920,27,20,-7,848
"3838",82921,56,42,-14,848
"3839",82922,82,65,-17,848
"3840",82923,82,67,-15,848
"3841",82924,60,51,-9,848
"3842",82925,35,33,-2,848
"3843",83633,13,11,-2,848
"3844",83634,13,11,-2,848
"3845",83635,13,11,-2,848
"3846",83636,14,11,-3,848
"3847",83637,15,12,-3,848
"3848",83638,15,12,-3,848
"3849",83639,16,12,-4,848
"3850",83640,17,12,-5,848
"3851",83641,17,14,-3,848
"3852",83642,24,21,-3,848
"3853",83643,24,20,-4,848
"3854",83644,23,20,-3,848
"3855",84354,13,11,-2,848
"3856",84355,14,11,-3,848
"3857",84356,14,11,-3,848
"3858",84357,14,11,-3,848
"3859",84358,15,12,-3,848
"3860",84359,15,12,-3,848
"3861",84360,16,12,-4,848
"3862",84361,13,12,-1,848
"3863",84362,28,21,-7,848
"3864",84363,27,20,-7,848
"3865",84364,27,20,-7,848
"3866",85076,13,12,-1,848
"3867",85077,13,11,-2,848
"3868",85078,12,12,0,848
"3869",85079,11,12,1,848
"3870",85080,12,12,0,848
"3871",85081,14,12,-2,848
"3872",85082,16,13,-3,848
