"","INDEX","X2000","X2087","change","EEZID"
"1",82205,81,82,1,945
"2",82206,79,82,3,945
"3",82924,58,50,-8,945
"4",82925,34,39,5,945
"5",82926,150,146,-4,945
"6",82927,141,142,1,945
"7",83644,23,26,3,945
"8",83645,25,28,3,945
"9",83646,34,40,6,945
"10",83647,33,38,5,945
"11",83651,128,119,-9,945
"12",83652,127,119,-8,945
"13",83653,127,117,-10,945
"14",84362,23,27,4,945
"15",84363,26,30,4,945
"16",84364,26,30,4,945
"17",84365,20,25,5,945
"18",84366,21,27,6,945
"19",84367,140,141,1,945
"20",84368,139,142,3,945
"21",84371,145,136,-9,945
"22",84372,148,136,-12,945
"23",84373,148,135,-13,945
"24",84374,148,135,-13,945
"25",85077,13,12,-1,945
"26",85078,12,12,0,945
"27",85079,11,14,3,945
"28",85080,12,14,2,945
"29",85081,14,16,2,945
"30",85082,15,18,3,945
"31",85083,16,22,6,945
"32",85084,16,22,6,945
"33",85085,27,24,-3,945
"34",85086,27,25,-2,945
"35",85087,31,28,-3,945
"36",85088,75,76,1,945
"37",85091,132,121,-11,945
"38",85092,144,131,-13,945
"39",85093,128,111,-17,945
"40",85094,147,131,-16,945
"41",85095,105,93,-12,945
"42",85796,12,11,-1,945
"43",85797,12,11,-1,945
"44",85798,12,12,0,945
"45",85799,11,15,4,945
"46",85800,12,16,4,945
"47",85801,14,18,4,945
"48",85802,14,18,4,945
"49",85803,13,19,6,945
"50",85804,14,20,6,945
"51",85805,26,23,-3,945
"52",85806,26,24,-2,945
"53",85807,28,25,-3,945
"54",85808,155,157,2,945
"55",85809,154,156,2,945
"56",85811,146,139,-7,945
"57",85812,161,151,-10,945
"58",85813,112,101,-11,945
"59",85814,140,122,-18,945
"60",85815,131,116,-15,945
"61",86516,12,14,2,945
"62",86517,11,15,4,945
"63",86518,11,16,5,945
"64",86519,12,17,5,945
"65",86520,14,18,4,945
"66",86521,14,19,5,945
"67",86522,14,19,5,945
"68",86523,14,20,6,945
"69",86524,14,19,5,945
"70",86525,23,21,-2,945
"71",86526,33,31,-2,945
"72",86527,42,41,-1,945
"73",86528,51,49,-2,945
"74",86529,155,148,-7,945
"75",86530,139,135,-4,945
"76",86532,149,138,-11,945
"77",86533,153,139,-14,945
"78",86534,153,137,-16,945
"79",86535,152,137,-15,945
"80",86536,120,112,-8,945
"81",87236,10,14,4,945
"82",87237,11,15,4,945
"83",87238,11,15,4,945
"84",87239,11,17,6,945
"85",87240,13,17,4,945
"86",87241,13,18,5,945
"87",87242,13,18,5,945
"88",87243,16,20,4,945
"89",87244,20,19,-1,945
"90",87245,23,20,-3,945
"91",87246,27,27,0,945
"92",87247,37,37,0,945
"93",87248,39,40,1,945
"94",87249,115,110,-5,945
"95",87250,157,151,-6,945
"96",87251,152,147,-5,945
"97",87253,147,137,-10,945
"98",87254,151,137,-14,945
"99",87255,112,101,-11,945
"100",87256,101,93,-8,945
"101",87956,10,18,8,945
"102",87957,12,18,6,945
"103",87958,12,18,6,945
"104",87959,12,19,7,945
"105",87960,13,19,6,945
"106",87961,13,19,6,945
"107",87962,14,19,5,945
"108",87963,20,19,-1,945
"109",87964,21,18,-3,945
"110",87965,22,19,-3,945
"111",87966,22,20,-2,945
"112",87967,24,20,-4,945
"113",87968,32,28,-4,945
"114",87969,80,70,-10,945
"115",87970,116,97,-19,945
"116",87971,139,129,-10,945
"117",87972,136,125,-11,945
"118",87974,144,135,-9,945
"119",87975,149,138,-11,945
"120",87976,144,137,-7,945
"121",87977,128,122,-6,945
"122",88676,10,18,8,945
"123",88677,12,18,6,945
"124",88678,12,18,6,945
"125",88679,12,18,6,945
"126",88680,12,19,7,945
"127",88681,14,19,5,945
"128",88682,14,19,5,945
"129",88683,20,19,-1,945
"130",88684,21,19,-2,945
"131",88685,21,19,-2,945
"132",88686,22,20,-2,945
"133",88687,24,20,-4,945
"134",88688,24,20,-4,945
"135",88689,155,126,-29,945
"136",88690,156,126,-30,945
"137",88691,150,134,-16,945
"138",88692,145,131,-14,945
"139",88695,130,123,-7,945
"140",88696,132,125,-7,945
"141",88697,143,136,-7,945
"142",88698,141,134,-7,945
"143",89397,15,18,3,945
"144",89398,15,18,3,945
"145",89399,17,18,1,945
"146",89400,18,19,1,945
"147",89401,19,19,0,945
"148",89402,19,19,0,945
"149",89403,20,19,-1,945
"150",89404,21,19,-2,945
"151",89405,21,19,-2,945
"152",89406,21,20,-1,945
"153",89407,22,20,-2,945
"154",89408,23,20,-3,945
"155",89409,76,73,-3,945
"156",89410,151,139,-12,945
"157",89411,145,135,-10,945
"158",89412,131,120,-11,945
"159",89413,75,72,-3,945
"160",89415,138,136,-2,945
"161",89416,140,138,-2,945
"162",89417,54,46,-8,945
"163",89418,143,140,-3,945
"164",89419,141,138,-3,945
"165",90117,15,18,3,945
"166",90118,16,18,2,945
"167",90119,18,18,0,945
"168",90120,18,19,1,945
"169",90121,19,19,0,945
"170",90122,19,19,0,945
"171",90123,20,19,-1,945
"172",90124,21,19,-2,945
"173",90125,21,19,-2,945
"174",90126,20,20,0,945
"175",90127,22,20,-2,945
"176",90128,22,20,-2,945
"177",90129,24,21,-3,945
"178",90130,32,29,-3,945
"179",90131,146,135,-11,945
"180",90132,143,136,-7,945
"181",90136,139,138,-1,945
"182",90137,141,140,-1,945
"183",90138,26,18,-8,945
"184",90139,141,138,-3,945
"185",90140,139,136,-3,945
"186",90141,100,101,1,945
"187",90838,17,18,1,945
"188",90839,18,18,0,945
"189",90840,18,19,1,945
"190",90841,19,19,0,945
"191",90842,19,19,0,945
"192",90843,18,19,1,945
"193",90844,20,19,-1,945
"194",90845,22,19,-3,945
"195",90846,22,19,-3,945
"196",90847,22,19,-3,945
"197",90848,22,20,-2,945
"198",90849,22,20,-2,945
"199",90850,23,21,-2,945
"200",90851,23,16,-7,945
"201",90852,110,105,-5,945
"202",90853,123,120,-3,945
"203",90854,120,117,-3,945
"204",90855,96,95,-1,945
"205",90857,139,138,-1,945
"206",90858,141,140,-1,945
"207",90859,27,19,-8,945
"208",90860,126,130,4,945
"209",90861,128,134,6,945
"210",90862,112,119,7,945
"211",91559,17,18,1,945
"212",91560,17,19,2,945
"213",91561,18,19,1,945
"214",91562,18,19,1,945
"215",91563,18,19,1,945
"216",91564,20,19,-1,945
"217",91565,22,19,-3,945
"218",91566,22,19,-3,945
"219",91567,22,19,-3,945
"220",91568,22,19,-3,945
"221",91569,22,20,-2,945
"222",91570,25,22,-3,945
"223",91571,24,17,-7,945
"224",91572,23,16,-7,945
"225",91573,111,109,-2,945
"226",91574,111,109,-2,945
"227",91575,120,116,-4,945
"228",91576,107,105,-2,945
"229",91578,96,93,-3,945
"230",91579,96,94,-2,945
"231",91580,32,26,-6,945
"232",91581,127,133,6,945
"233",91582,122,129,7,945
"234",92280,18,19,1,945
"235",92281,20,19,-1,945
"236",92282,20,19,-1,945
"237",92283,20,19,-1,945
"238",92284,20,19,-1,945
"239",92285,21,19,-2,945
"240",92286,22,19,-3,945
"241",92287,22,19,-3,945
"242",92288,22,19,-3,945
"243",92289,21,19,-2,945
"244",92290,21,19,-2,945
"245",92291,17,15,-2,945
"246",92292,18,15,-3,945
"247",92293,33,28,-5,945
"248",92294,74,70,-4,945
"249",92295,119,113,-6,945
"250",92296,116,110,-6,945
"251",92298,124,121,-3,945
"252",92299,129,125,-4,945
"253",92300,32,28,-4,945
"254",92301,98,99,1,945
"255",92302,121,118,-3,945
"256",92303,75,70,-5,945
"257",93002,23,22,-1,945
"258",93003,20,19,-1,945
"259",93004,20,19,-1,945
"260",93005,20,19,-1,945
"261",93006,21,19,-2,945
"262",93007,22,19,-3,945
"263",93008,23,20,-3,945
"264",93009,22,20,-2,945
"265",93010,21,19,-2,945
"266",93011,17,14,-3,945
"267",93012,17,15,-2,945
"268",93013,24,19,-5,945
"269",93014,69,66,-3,945
"270",93015,108,100,-8,945
"271",93016,104,97,-7,945
"272",93019,78,77,-1,945
"273",93020,79,78,-1,945
"274",93021,20,18,-2,945
"275",93022,124,121,-3,945
"276",93023,123,120,-3,945
"277",93024,116,115,-1,945
"278",93722,20,19,-1,945
"279",93723,20,19,-1,945
"280",93724,20,19,-1,945
"281",93725,20,19,-1,945
"282",93726,21,20,-1,945
"283",93727,21,20,-1,945
"284",93728,21,20,-1,945
"285",93729,22,17,-5,945
"286",93730,21,15,-6,945
"287",93731,21,15,-6,945
"288",93732,22,16,-6,945
"289",93733,22,19,-3,945
"290",93734,26,21,-5,945
"291",93735,81,73,-8,945
"292",93736,119,113,-6,945
"293",93737,115,110,-5,945
"294",93739,117,118,1,945
"295",93740,120,120,0,945
"296",93741,42,40,-2,945
"297",93742,26,23,-3,945
"298",93743,86,79,-7,945
"299",93744,124,119,-5,945
"300",93745,109,105,-4,945
"301",94442,20,19,-1,945
"302",94443,20,19,-1,945
"303",94444,20,19,-1,945
"304",94445,20,19,-1,945
"305",94446,20,19,-1,945
"306",94447,20,19,-1,945
"307",94448,21,20,-1,945
"308",94449,22,16,-6,945
"309",94450,21,15,-6,945
"310",94451,21,15,-6,945
"311",94452,22,15,-7,945
"312",94453,22,19,-3,945
"313",94454,22,19,-3,945
"314",94455,27,25,-2,945
"315",94456,81,67,-14,945
"316",94457,117,98,-19,945
"317",94458,116,97,-19,945
"318",94459,115,111,-4,945
"319",94460,116,113,-3,945
"320",94461,116,111,-5,945
"321",94462,42,42,0,945
"322",94463,27,24,-3,945
"323",94464,103,100,-3,945
"324",94465,115,113,-2,945
"325",94466,109,107,-2,945
"326",95162,20,19,-1,945
"327",95163,20,19,-1,945
"328",95164,20,19,-1,945
"329",95165,19,19,0,945
"330",95166,19,19,0,945
"331",95167,20,19,-1,945
"332",95168,20,19,-1,945
"333",95169,21,13,-8,945
"334",95170,21,13,-8,945
"335",95171,21,17,-4,945
"336",95172,21,17,-4,945
"337",95173,21,19,-2,945
"338",95174,22,20,-2,945
"339",95175,22,19,-3,945
"340",95176,61,48,-13,945
"341",95177,70,50,-20,945
"342",95178,69,49,-20,945
"343",95179,113,95,-18,945
"344",95180,108,104,-4,945
"345",95181,113,109,-4,945
"346",95182,112,105,-7,945
"347",95183,22,19,-3,945
"348",95184,28,26,-2,945
"349",95185,86,80,-6,945
"350",95186,112,112,0,945
"351",95187,102,100,-2,945
"352",95882,20,19,-1,945
"353",95883,20,19,-1,945
"354",95884,20,19,-1,945
"355",95885,19,19,0,945
"356",95886,19,19,0,945
"357",95887,20,19,-1,945
"358",95888,20,18,-2,945
"359",95889,20,13,-7,945
"360",95890,21,13,-8,945
"361",95891,21,17,-4,945
"362",95892,21,17,-4,945
"363",95893,21,19,-2,945
"364",95894,22,20,-2,945
"365",95895,22,19,-3,945
"366",95896,23,19,-4,945
"367",95897,34,24,-10,945
"368",95898,38,28,-10,945
"369",95899,69,45,-24,945
"370",95900,111,93,-18,945
"371",95901,108,102,-6,945
"372",95902,109,101,-8,945
"373",95903,22,19,-3,945
"374",95904,22,18,-4,945
"375",95905,22,20,-2,945
"376",95906,64,54,-10,945
"377",95907,110,95,-15,945
"378",95908,105,90,-15,945
"379",96603,19,19,0,945
"380",96604,19,19,0,945
"381",96605,20,15,-5,945
"382",96606,20,15,-5,945
"383",96607,20,12,-8,945
"384",96608,21,13,-8,945
"385",96609,15,16,1,945
"386",96610,16,16,0,945
"387",96611,21,17,-4,945
"388",96612,21,17,-4,945
"389",96613,21,19,-2,945
"390",96614,23,20,-3,945
"391",96615,23,19,-4,945
"392",96616,23,19,-4,945
"393",96617,20,18,-2,945
"394",96618,20,18,-2,945
"395",96619,23,12,-11,945
"396",96620,109,90,-19,945
"397",96621,109,90,-19,945
"398",96622,38,28,-10,945
"399",96623,20,11,-9,945
"400",96624,20,10,-10,945
"401",96625,24,12,-12,945
"402",96626,24,13,-11,945
"403",96627,61,44,-17,945
"404",96628,106,94,-12,945
"405",96629,98,84,-14,945
"406",97324,18,18,0,945
"407",97325,19,14,-5,945
"408",97326,19,14,-5,945
"409",97327,20,12,-8,945
"410",97328,20,12,-8,945
"411",97329,15,15,0,945
"412",97330,16,15,-1,945
"413",97331,21,17,-4,945
"414",97332,21,17,-4,945
"415",97333,22,19,-3,945
"416",97334,23,20,-3,945
"417",97335,23,19,-4,945
"418",97336,22,20,-2,945
"419",97337,20,18,-2,945
"420",97338,20,18,-2,945
"421",97339,20,9,-11,945
"422",97340,20,9,-11,945
"423",97341,20,11,-9,945
"424",97342,20,11,-9,945
"425",97343,20,11,-9,945
"426",97344,20,11,-9,945
"427",97345,20,10,-10,945
"428",97346,20,10,-10,945
"429",97347,55,36,-19,945
"430",97348,106,91,-15,945
"431",97349,101,87,-14,945
"432",98046,13,11,-2,945
"433",98047,17,13,-4,945
"434",98048,18,13,-5,945
"435",98049,20,16,-4,945
"436",98050,20,16,-4,945
"437",98051,20,17,-3,945
"438",98052,21,17,-4,945
"439",98053,21,18,-3,945
"440",98054,20,18,-2,945
"441",98055,21,18,-3,945
"442",98056,21,19,-2,945
"443",98057,20,19,-1,945
"444",98058,20,19,-1,945
"445",98059,20,18,-2,945
"446",98060,20,17,-3,945
"447",98061,20,11,-9,945
"448",98062,20,11,-9,945
"449",98063,20,7,-13,945
"450",98064,20,7,-13,945
"451",98065,20,7,-13,945
"452",98066,20,7,-13,945
"453",98067,104,83,-21,945
"454",98068,103,83,-20,945
"455",98069,98,80,-18,945
"456",98070,93,73,-20,945
"457",98767,18,17,-1,945
"458",98768,20,17,-3,945
"459",98769,20,17,-3,945
"460",98770,20,17,-3,945
"461",98771,21,17,-4,945
"462",98772,21,17,-4,945
"463",98773,21,18,-3,945
"464",98774,20,19,-1,945
"465",98775,21,18,-3,945
"466",98776,21,18,-3,945
"467",98777,20,18,-2,945
"468",98778,20,18,-2,945
"469",98779,20,18,-2,945
"470",98780,20,18,-2,945
"471",98781,20,11,-9,945
"472",98782,20,11,-9,945
"473",98783,20,8,-12,945
"474",98784,20,7,-13,945
"475",98785,18,7,-11,945
"476",98786,18,7,-11,945
"477",98787,20,8,-12,945
"478",98788,81,55,-26,945
"479",98789,81,56,-25,945
"480",98790,79,55,-24,945
"481",99486,18,14,-4,945
"482",99487,19,17,-2,945
"483",99488,18,17,-1,945
"484",99489,20,17,-3,945
"485",99490,21,17,-4,945
"486",99491,21,17,-4,945
"487",99492,21,17,-4,945
"488",99493,21,19,-2,945
"489",99494,20,19,-1,945
"490",99495,21,18,-3,945
"491",99496,20,18,-2,945
"492",99497,19,18,-1,945
"493",99498,19,18,-1,945
"494",99499,20,18,-2,945
"495",99500,20,18,-2,945
"496",99501,20,11,-9,945
"497",99502,20,11,-9,945
"498",99503,20,8,-12,945
"499",99504,20,7,-13,945
"500",99505,18,7,-11,945
"501",99506,18,7,-11,945
"502",99507,19,7,-12,945
"503",99508,55,28,-27,945
"504",99509,96,76,-20,945
"505",99510,96,76,-20,945
"506",100205,16,16,0,945
"507",100206,16,17,1,945
"508",100207,17,17,0,945
"509",100208,18,17,-1,945
"510",100209,20,17,-3,945
"511",100210,21,17,-4,945
"512",100211,20,18,-2,945
"513",100212,20,19,-1,945
"514",100213,19,19,0,945
"515",100214,19,19,0,945
"516",100215,20,18,-2,945
"517",100216,20,18,-2,945
"518",100217,20,18,-2,945
"519",100218,20,18,-2,945
"520",100219,20,18,-2,945
"521",100220,20,15,-5,945
"522",100221,20,10,-10,945
"523",100222,20,8,-12,945
"524",100223,20,7,-13,945
"525",100224,20,7,-13,945
"526",100225,20,7,-13,945
"527",100226,20,7,-13,945
"528",100227,20,7,-13,945
"529",100228,21,7,-14,945
"530",100229,75,52,-23,945
"531",100230,72,50,-22,945
"532",100924,14,16,2,945
"533",100925,16,16,0,945
"534",100926,16,16,0,945
"535",100927,17,17,0,945
"536",100928,17,17,0,945
"537",100929,19,17,-2,945
"538",100930,20,17,-3,945
"539",100931,19,18,-1,945
"540",100932,19,19,0,945
"541",100933,20,19,-1,945
"542",100934,19,19,0,945
"543",100935,20,18,-2,945
"544",100936,20,18,-2,945
"545",100937,19,18,-1,945
"546",100938,19,18,-1,945
"547",100939,19,17,-2,945
"548",100940,19,12,-7,945
"549",100941,19,8,-11,945
"550",100942,20,8,-12,945
"551",100943,20,7,-13,945
"552",100944,20,7,-13,945
"553",100945,20,7,-13,945
"554",100946,20,7,-13,945
"555",100947,20,7,-13,945
"556",100948,21,7,-14,945
"557",100949,67,45,-22,945
"558",100950,63,44,-19,945
"559",101644,13,17,4,945
"560",101645,14,17,3,945
"561",101646,16,17,1,945
"562",101647,17,18,1,945
"563",101648,18,18,0,945
"564",101649,18,18,0,945
"565",101650,19,18,-1,945
"566",101651,19,18,-1,945
"567",101652,20,19,-1,945
"568",101653,20,18,-2,945
"569",101654,20,18,-2,945
"570",101655,20,18,-2,945
"571",101656,18,18,0,945
"572",101657,18,18,0,945
"573",101658,18,18,0,945
"574",101659,16,10,-6,945
"575",101660,18,12,-6,945
"576",101661,19,8,-11,945
"577",101662,19,7,-12,945
"578",101663,19,7,-12,945
"579",101664,19,7,-12,945
"580",101665,18,7,-11,945
"581",101666,19,7,-12,945
"582",101667,19,7,-12,945
"583",101668,19,7,-12,945
"584",101669,20,9,-11,945
"585",101670,83,65,-18,945
"586",101671,83,68,-15,945
"587",101672,79,64,-15,945
"588",102364,13,17,4,945
"589",102365,13,17,4,945
"590",102366,14,17,3,945
"591",102367,16,18,2,945
"592",102368,17,18,1,945
"593",102369,18,18,0,945
"594",102370,18,18,0,945
"595",102371,18,18,0,945
"596",102372,19,19,0,945
"597",102373,19,18,-1,945
"598",102374,19,18,-1,945
"599",102375,18,18,0,945
"600",102376,18,18,0,945
"601",102377,18,18,0,945
"602",102378,31,23,-8,945
"603",102379,29,18,-11,945
"604",102380,18,11,-7,945
"605",102381,19,7,-12,945
"606",102382,19,7,-12,945
"607",102383,19,7,-12,945
"608",102384,18,7,-11,945
"609",102385,18,7,-11,945
"610",102386,18,7,-11,945
"611",102387,19,7,-12,945
"612",102388,19,7,-12,945
"613",102389,18,7,-11,945
"614",102390,19,8,-11,945
"615",102391,26,16,-10,945
"616",102392,83,68,-15,945
"617",102393,84,66,-18,945
"618",103084,12,18,6,945
"619",103085,13,18,5,945
"620",103086,13,18,5,945
"621",103087,16,18,2,945
"622",103088,16,18,2,945
"623",103089,16,18,2,945
"624",103090,17,18,1,945
"625",103091,16,16,0,945
"626",103092,17,18,1,945
"627",103093,17,18,1,945
"628",103094,16,18,2,945
"629",103095,17,18,1,945
"630",103096,17,18,1,945
"631",103097,18,17,-1,945
"632",103098,19,12,-7,945
"633",103099,18,11,-7,945
"634",103100,18,8,-10,945
"635",103101,18,7,-11,945
"636",103102,18,7,-11,945
"637",103103,17,7,-10,945
"638",103104,18,7,-11,945
"639",103105,19,7,-12,945
"640",103106,19,7,-12,945
"641",103107,19,7,-12,945
"642",103108,19,7,-12,945
"643",103109,18,7,-11,945
"644",103110,19,7,-12,945
"645",103111,18,8,-10,945
"646",103112,22,12,-10,945
"647",103113,85,62,-23,945
"648",103114,84,62,-22,945
"649",103115,83,61,-22,945
"650",103116,59,40,-19,945
"651",103804,12,18,6,945
"652",103805,13,18,5,945
"653",103806,13,18,5,945
"654",103807,15,17,2,945
"655",103808,15,17,2,945
"656",103809,16,17,1,945
"657",103810,16,17,1,945
"658",103811,15,17,2,945
"659",103812,15,18,3,945
"660",103813,15,18,3,945
"661",103814,16,18,2,945
"662",103815,16,18,2,945
"663",103816,16,17,1,945
"664",103817,17,11,-6,945
"665",103818,18,11,-7,945
"666",103819,18,9,-9,945
"667",103820,18,7,-11,945
"668",103821,17,7,-10,945
"669",103822,17,7,-10,945
"670",103823,16,7,-9,945
"671",103824,17,7,-10,945
"672",103825,18,7,-11,945
"673",103826,19,7,-12,945
"674",103827,18,7,-11,945
"675",103828,19,7,-12,945
"676",103829,19,7,-12,945
"677",103830,19,7,-12,945
"678",103831,20,7,-13,945
"679",103832,20,7,-13,945
"680",103833,21,7,-14,945
"681",103834,25,11,-14,945
"682",103835,60,35,-25,945
"683",103836,84,61,-23,945
"684",103837,84,61,-23,945
"685",103838,77,52,-25,945
"686",104524,12,18,6,945
"687",104525,13,18,5,945
"688",104526,14,18,4,945
"689",104527,14,17,3,945
"690",104528,15,17,2,945
"691",104529,15,17,2,945
"692",104530,15,17,2,945
"693",104531,15,17,2,945
"694",104532,15,17,2,945
"695",104533,15,18,3,945
"696",104534,16,18,2,945
"697",104535,15,17,2,945
"698",104536,15,12,-3,945
"699",104537,15,11,-4,945
"700",104538,16,9,-7,945
"701",104539,15,7,-8,945
"702",104540,16,7,-9,945
"703",104541,15,7,-8,945
"704",104542,15,7,-8,945
"705",104543,14,7,-7,945
"706",104544,15,7,-8,945
"707",104545,18,7,-11,945
"708",104546,18,7,-11,945
"709",104547,19,7,-12,945
"710",104548,20,7,-13,945
"711",104549,20,7,-13,945
"712",104550,20,7,-13,945
"713",104551,20,7,-13,945
"714",104552,20,7,-13,945
"715",104553,19,7,-12,945
"716",104554,19,7,-12,945
"717",104555,20,7,-13,945
"718",104556,22,9,-13,945
"719",104557,25,12,-13,945
"720",104558,83,64,-19,945
"721",104559,80,61,-19,945
"722",104560,77,60,-17,945
"723",105245,14,17,3,945
"724",105246,14,17,3,945
"725",105247,14,17,3,945
"726",105248,14,17,3,945
"727",105249,14,17,3,945
"728",105250,15,17,2,945
"729",105251,15,17,2,945
"730",105252,15,17,2,945
"731",105253,14,17,3,945
"732",105254,15,15,0,945
"733",105255,15,11,-4,945
"734",105256,15,11,-4,945
"735",105257,15,8,-7,945
"736",105258,14,7,-7,945
"737",105259,14,7,-7,945
"738",105260,14,7,-7,945
"739",105261,14,7,-7,945
"740",105262,14,7,-7,945
"741",105263,13,7,-6,945
"742",105264,15,7,-8,945
"743",105265,17,7,-10,945
"744",105266,18,7,-11,945
"745",105267,18,7,-11,945
"746",105268,19,7,-12,945
"747",105269,19,7,-12,945
"748",105270,19,7,-12,945
"749",105271,18,7,-11,945
"750",105272,18,7,-11,945
"751",105273,18,7,-11,945
"752",105274,18,7,-11,945
"753",105275,18,7,-11,945
"754",105276,18,7,-11,945
"755",105277,19,7,-12,945
"756",105278,20,8,-12,945
"757",105279,25,11,-14,945
"758",105280,83,65,-18,945
"759",105281,83,67,-16,945
"760",105282,83,66,-17,945
"761",105283,76,61,-15,945
"762",105965,14,17,3,945
"763",105966,14,17,3,945
"764",105967,14,17,3,945
"765",105968,14,17,3,945
"766",105969,14,17,3,945
"767",105970,14,17,3,945
"768",105971,14,15,1,945
"769",105972,14,10,-4,945
"770",105973,14,10,-4,945
"771",105974,15,10,-5,945
"772",105975,15,10,-5,945
"773",105976,15,8,-7,945
"774",105977,14,7,-7,945
"775",105978,14,7,-7,945
"776",105979,13,7,-6,945
"777",105980,13,7,-6,945
"778",105981,13,7,-6,945
"779",105982,15,8,-7,945
"780",105983,15,8,-7,945
"781",105984,14,7,-7,945
"782",105987,18,7,-11,945
"783",105988,18,7,-11,945
"784",105989,19,7,-12,945
"785",105990,20,7,-13,945
"786",105991,18,7,-11,945
"787",105992,18,7,-11,945
"788",105993,18,7,-11,945
"789",105994,18,7,-11,945
"790",105995,18,7,-11,945
"791",105996,18,7,-11,945
"792",105997,18,7,-11,945
"793",105998,18,7,-11,945
"794",105999,20,7,-13,945
"795",106000,21,8,-13,945
"796",106001,22,10,-12,945
"797",106002,28,15,-13,945
"798",106003,88,68,-20,945
"799",106004,87,68,-19,945
"800",106005,80,65,-15,945
"801",106010,78,64,-14,945
"802",106011,79,66,-13,945
"803",106012,79,67,-12,945
"804",106686,14,17,3,945
"805",106687,14,17,3,945
"806",106688,14,17,3,945
"807",106689,14,17,3,945
"808",106690,14,16,2,945
"809",106691,14,10,-4,945
"810",106692,14,10,-4,945
"811",106693,14,10,-4,945
"812",106694,15,9,-6,945
"813",106695,15,8,-7,945
"814",106696,14,7,-7,945
"815",106697,14,7,-7,945
"816",106698,13,7,-6,945
"817",106699,13,7,-6,945
"818",106700,13,7,-6,945
"819",106701,13,7,-6,945
"820",106702,13,7,-6,945
"821",106703,15,7,-8,945
"822",106709,18,7,-11,945
"823",106710,18,7,-11,945
"824",106711,18,7,-11,945
"825",106712,18,7,-11,945
"826",106713,18,7,-11,945
"827",106714,18,7,-11,945
"828",106715,18,7,-11,945
"829",106716,18,7,-11,945
"830",106717,18,7,-11,945
"831",106718,18,7,-11,945
"832",106719,20,7,-13,945
"833",106720,20,7,-13,945
"834",106721,20,8,-12,945
"835",106722,20,8,-12,945
"836",106723,23,13,-10,945
"837",106724,26,16,-10,945
"838",106725,88,69,-19,945
"839",106726,88,70,-18,945
"840",106727,87,71,-16,945
"841",106728,87,71,-16,945
"842",106729,88,72,-16,945
"843",106730,87,72,-15,945
"844",106731,72,59,-13,945
"845",106732,82,68,-14,945
"846",106733,86,73,-13,945
"847",106734,83,71,-12,945
"848",107407,14,9,-5,945
"849",107408,14,9,-5,945
"850",107409,14,9,-5,945
"851",107410,15,9,-6,945
"852",107411,15,8,-7,945
"853",107412,15,8,-7,945
"854",107413,15,8,-7,945
"855",107414,15,8,-7,945
"856",107415,14,7,-7,945
"857",107417,13,7,-6,945
"858",107418,13,7,-6,945
"859",107419,13,7,-6,945
"860",107420,12,7,-5,945
"861",107430,18,7,-11,945
"862",107431,18,7,-11,945
"863",107432,19,7,-12,945
"864",107433,18,7,-11,945
"865",107434,18,7,-11,945
"866",107435,18,7,-11,945
"867",107436,18,7,-11,945
"868",107437,18,7,-11,945
"869",107438,18,7,-11,945
"870",107439,20,8,-12,945
"871",107440,20,8,-12,945
"872",107441,20,8,-12,945
"873",107442,20,8,-12,945
"874",107443,19,11,-8,945
"875",107444,19,11,-8,945
"876",107445,19,11,-8,945
"877",107446,19,11,-8,945
"878",107447,20,12,-8,945
"879",107448,20,12,-8,945
"880",107449,21,12,-9,945
"881",107450,22,13,-9,945
"882",107451,49,35,-14,945
"883",107452,49,35,-14,945
"884",107453,81,66,-15,945
"885",107454,88,75,-13,945
"886",107455,83,71,-12,945
"887",108152,17,7,-10,945
"888",108153,17,7,-10,945
"889",108154,18,7,-11,945
"890",108155,18,7,-11,945
"891",108156,18,7,-11,945
"892",108157,18,7,-11,945
"893",108158,18,7,-11,945
"894",108159,19,8,-11,945
"895",108160,19,8,-11,945
"896",108161,20,8,-12,945
"897",108162,20,8,-12,945
"898",108163,20,8,-12,945
"899",108164,20,8,-12,945
"900",108165,20,8,-12,945
"901",108166,19,8,-11,945
"902",108167,19,8,-11,945
"903",108168,19,8,-11,945
"904",108169,19,9,-10,945
"905",108170,19,9,-10,945
"906",108171,19,10,-9,945
"907",108172,57,40,-17,945
"908",108173,62,43,-19,945
"909",108174,82,67,-15,945
"910",108175,88,75,-13,945
"911",108176,82,70,-12,945
"912",108875,17,7,-10,945
"913",108876,17,7,-10,945
"914",108877,18,7,-11,945
"915",108878,18,7,-11,945
"916",108879,19,7,-12,945
"917",108880,19,8,-11,945
"918",108881,20,8,-12,945
"919",108882,20,7,-13,945
"920",108883,20,7,-13,945
"921",108884,20,7,-13,945
"922",108885,19,7,-12,945
"923",108886,19,7,-12,945
"924",108887,19,7,-12,945
"925",108888,19,7,-12,945
"926",108889,19,8,-11,945
"927",108890,18,8,-10,945
"928",108891,18,9,-9,945
"929",108892,18,9,-9,945
"930",108893,19,9,-10,945
"931",108894,33,22,-11,945
"932",108895,80,61,-19,945
"933",108896,91,74,-17,945
"934",109597,17,7,-10,945
"935",109598,19,7,-12,945
"936",109599,19,7,-12,945
"937",109600,19,7,-12,945
"938",109601,20,7,-13,945
"939",109602,20,7,-13,945
"940",109603,20,7,-13,945
"941",109604,19,7,-12,945
"942",109605,19,7,-12,945
"943",109606,19,7,-12,945
"944",109607,19,7,-12,945
"945",109608,18,7,-11,945
"946",109609,18,7,-11,945
"947",109610,18,7,-11,945
"948",109611,18,7,-11,945
"949",109612,19,7,-12,945
"950",109613,19,7,-12,945
"951",109614,21,7,-14,945
"952",109615,23,9,-14,945
"953",110319,17,7,-10,945
"954",110320,17,7,-10,945
"955",110321,17,7,-10,945
"956",110322,17,7,-10,945
"957",110323,17,7,-10,945
"958",110324,17,7,-10,945
"959",110325,17,7,-10,945
"960",110326,17,7,-10,945
"961",110327,17,7,-10,945
"962",110328,16,7,-9,945
"963",110329,16,7,-9,945
"964",110330,16,7,-9,945
"965",110331,16,7,-9,945
"966",110332,17,7,-10,945
"967",110333,18,7,-11,945
"968",110334,18,7,-11,945
"969",111042,17,7,-10,945
"970",111043,17,7,-10,945
"971",111044,17,7,-10,945
"972",111045,17,7,-10,945
"973",111046,16,7,-9,945
"974",111047,16,7,-9,945
"975",111048,16,7,-9,945
"976",111049,16,7,-9,945
"977",111050,16,7,-9,945
"978",111051,16,7,-9,945
"979",111052,16,7,-9,945
"980",111053,18,7,-11,945
"981",111765,17,7,-10,945
"982",111766,16,7,-9,945
"983",111767,16,7,-9,945
"984",111768,16,7,-9,945
"985",111769,16,7,-9,945
"986",111770,16,7,-9,945
"987",111771,12,7,-5,945
"988",111772,13,7,-6,945
"989",34583,42,67,25,959
"990",34584,42,65,23,959
"991",34585,32,61,29,959
"992",35300,40,65,25,959
"993",35301,44,67,23,959
"994",35302,43,66,23,959
"995",35303,46,65,19,959
"996",35304,45,68,23,959
"997",35305,43,65,22,959
"998",35306,41,62,21,959
"999",35307,36,57,21,959
"1000",35308,7,13,6,959
"1001",36018,42,65,23,959
"1002",36019,46,67,21,959
"1003",36020,44,67,23,959
"1004",36021,47,68,21,959
"1005",36022,46,65,19,959
"1006",36023,48,66,18,959
"1007",36024,51,67,16,959
"1008",36025,51,64,13,959
"1009",36026,52,66,14,959
"1010",36027,50,60,10,959
"1011",36028,37,60,23,959
"1012",36029,24,51,27,959
"1013",36031,8,16,8,959
"1014",36032,25,54,29,959
"1015",36033,26,53,27,959
"1016",36034,26,51,25,959
"1017",36035,2,5,3,959
"1018",36036,26,48,22,959
"1019",36037,27,47,20,959
"1020",36038,22,42,20,959
"1021",36039,19,34,15,959
"1022",36736,45,62,17,959
"1023",36737,48,61,13,959
"1024",36738,46,63,17,959
"1025",36739,47,63,16,959
"1026",36740,45,63,18,959
"1027",36741,44,61,17,959
"1028",36742,48,64,16,959
"1029",36743,51,65,14,959
"1030",36744,51,64,13,959
"1031",36745,52,62,10,959
"1032",36746,54,61,7,959
"1033",36747,52,59,7,959
"1034",36748,51,61,10,959
"1035",36749,49,61,12,959
"1036",36750,47,61,14,959
"1037",36751,41,57,16,959
"1038",36752,38,54,16,959
"1039",36753,37,55,18,959
"1040",36754,35,56,21,959
"1041",36755,32,51,19,959
"1042",36756,34,49,15,959
"1043",36757,35,53,18,959
"1044",36758,30,53,23,959
"1045",36759,15,28,13,959
"1046",37454,52,59,7,959
"1047",37455,48,61,13,959
"1048",37456,49,62,13,959
"1049",37457,53,60,7,959
"1050",37458,51,59,8,959
"1051",37459,53,63,10,959
"1052",37460,49,63,14,959
"1053",37461,50,65,15,959
"1054",37462,49,62,13,959
"1055",37463,55,64,9,959
"1056",37464,58,63,5,959
"1057",37465,57,64,7,959
"1058",37466,54,62,8,959
"1059",37467,58,64,6,959
"1060",37468,53,62,9,959
"1061",37469,55,61,6,959
"1062",37470,50,60,10,959
"1063",37471,44,57,13,959
"1064",37472,37,56,19,959
"1065",37473,33,50,17,959
"1066",37474,31,53,22,959
"1067",37475,34,52,18,959
"1068",37476,34,53,19,959
"1069",37477,32,52,20,959
"1070",37478,32,53,21,959
"1071",37479,31,53,22,959
"1072",38172,57,62,5,959
"1073",38173,57,59,2,959
"1074",38174,58,59,1,959
"1075",38175,53,59,6,959
"1076",38176,55,59,4,959
"1077",38177,59,61,2,959
"1078",38178,57,64,7,959
"1079",38179,56,65,9,959
"1080",38180,47,61,14,959
"1081",38181,37,61,24,959
"1082",38182,48,61,13,959
"1083",38183,57,64,7,959
"1084",38184,58,65,7,959
"1085",38185,56,65,9,959
"1086",38186,56,64,8,959
"1087",38187,54,63,9,959
"1088",38188,53,61,8,959
"1089",38189,53,61,8,959
"1090",38190,50,59,9,959
"1091",38191,42,59,17,959
"1092",38192,31,59,28,959
"1093",38193,33,54,21,959
"1094",38194,35,55,20,959
"1095",38195,34,54,20,959
"1096",38196,30,53,23,959
"1097",38197,19,30,11,959
"1098",38890,59,60,1,959
"1099",38891,57,64,7,959
"1100",38892,58,63,5,959
"1101",38893,61,64,3,959
"1102",38894,58,63,5,959
"1103",38895,47,63,16,959
"1104",38896,45,61,16,959
"1105",38897,57,63,6,959
"1106",38898,57,64,7,959
"1107",38899,57,61,4,959
"1108",38900,56,59,3,959
"1109",38901,59,61,2,959
"1110",38902,56,61,5,959
"1111",38903,56,61,5,959
"1112",38904,59,65,6,959
"1113",38905,56,62,6,959
"1114",38906,57,64,7,959
"1115",38907,54,64,10,959
"1116",38908,53,63,10,959
"1117",38909,55,64,9,959
"1118",38910,54,63,9,959
"1119",38911,40,58,18,959
"1120",39608,50,59,9,959
"1121",39609,56,58,2,959
"1122",39610,59,60,1,959
"1123",39611,58,62,4,959
"1124",39612,58,64,6,959
"1125",39613,58,62,4,959
"1126",39614,59,62,3,959
"1127",39615,49,64,15,959
"1128",39616,46,62,16,959
"1129",39617,59,64,5,959
"1130",39618,59,64,5,959
"1131",39619,61,64,3,959
"1132",39620,56,62,6,959
"1133",39621,59,61,2,959
"1134",39622,57,61,4,959
"1135",39623,57,58,1,959
"1136",39624,57,61,4,959
"1137",39625,55,61,6,959
"1138",39626,56,63,7,959
"1139",39627,57,66,9,959
"1140",39628,57,64,7,959
"1141",39629,59,67,8,959
"1142",39630,42,60,18,959
"1143",40326,53,57,4,959
"1144",40327,53,57,4,959
"1145",40328,55,58,3,959
"1146",40329,57,57,0,959
"1147",40330,56,59,3,959
"1148",40331,57,62,5,959
"1149",40332,59,62,3,959
"1150",40333,58,62,4,959
"1151",40334,58,61,3,959
"1152",40335,58,62,4,959
"1153",40336,60,64,4,959
"1154",40337,61,63,2,959
"1155",40338,60,63,3,959
"1156",40339,60,63,3,959
"1157",40340,59,63,4,959
"1158",40341,58,60,2,959
"1159",40342,58,59,1,959
"1160",40343,57,61,4,959
"1161",40344,54,60,6,959
"1162",40345,56,61,5,959
"1163",40346,56,64,8,959
"1164",40347,60,68,8,959
"1165",40348,62,69,7,959
"1166",40349,58,70,12,959
"1167",41044,44,52,8,959
"1168",41045,51,57,6,959
"1169",41046,52,57,5,959
"1170",41047,53,57,4,959
"1171",41048,54,59,5,959
"1172",41049,58,59,1,959
"1173",41050,59,60,1,959
"1174",41051,56,61,5,959
"1175",41052,59,62,3,959
"1176",41053,58,60,2,959
"1177",41054,60,62,2,959
"1178",41055,61,63,2,959
"1179",41056,58,64,6,959
"1180",41057,62,65,3,959
"1181",41058,60,63,3,959
"1182",41059,61,66,5,959
"1183",41060,58,63,5,959
"1184",41061,58,60,2,959
"1185",41062,59,62,3,959
"1186",41063,58,62,4,959
"1187",41064,59,63,4,959
"1188",41065,59,65,6,959
"1189",41066,56,63,7,959
"1190",41067,58,66,8,959
"1191",41068,58,65,7,959
"1192",41069,59,67,8,959
"1193",41070,59,66,7,959
"1194",41098,46,61,15,959
"1195",41099,50,65,15,959
"1196",41100,48,64,16,959
"1197",41101,43,56,13,959
"1198",41102,4,3,-1,959
"1199",41104,43,50,7,959
"1200",41105,45,50,5,959
"1201",41106,18,26,8,959
"1202",41107,45,49,4,959
"1203",41108,44,47,3,959
"1204",41762,31,43,12,959
"1205",41763,39,48,9,959
"1206",41764,48,54,6,959
"1207",41765,55,56,1,959
"1208",41766,54,58,4,959
"1209",41767,55,57,2,959
"1210",41768,57,59,2,959
"1211",41769,60,62,2,959
"1212",41770,61,61,0,959
"1213",41771,59,63,4,959
"1214",41772,57,61,4,959
"1215",41773,60,62,2,959
"1216",41774,66,69,3,959
"1217",41775,65,68,3,959
"1218",41776,65,67,2,959
"1219",41777,66,66,0,959
"1220",41778,62,64,2,959
"1221",41779,63,64,1,959
"1222",41780,61,64,3,959
"1223",41781,63,65,2,959
"1224",41782,60,62,2,959
"1225",41783,60,64,4,959
"1226",41784,58,64,6,959
"1227",41785,61,69,8,959
"1228",41786,61,69,8,959
"1229",41787,62,68,6,959
"1230",41788,61,66,5,959
"1231",41789,63,71,8,959
"1232",41790,67,74,7,959
"1233",41791,60,74,14,959
"1234",41816,69,73,4,959
"1235",41817,80,78,-2,959
"1236",41818,73,71,-2,959
"1237",41819,57,65,8,959
"1238",41820,43,48,5,959
"1239",41821,38,42,4,959
"1240",41822,38,41,3,959
"1241",41823,21,31,10,959
"1242",41824,62,66,4,959
"1243",41825,64,69,5,959
"1244",41826,70,70,0,959
"1245",41827,72,68,-4,959
"1246",41828,67,69,2,959
"1247",41829,49,61,12,959
"1248",42481,10,11,1,959
"1249",42482,21,30,9,959
"1250",42483,43,49,6,959
"1251",42484,50,54,4,959
"1252",42485,52,55,3,959
"1253",42486,54,56,2,959
"1254",42487,52,53,1,959
"1255",42488,54,57,3,959
"1256",42489,60,60,0,959
"1257",42490,61,61,0,959
"1258",42491,59,64,5,959
"1259",42492,61,64,3,959
"1260",42493,61,64,3,959
"1261",42494,60,65,5,959
"1262",42495,62,66,4,959
"1263",42496,64,67,3,959
"1264",42497,65,66,1,959
"1265",42498,63,64,1,959
"1266",42499,63,65,2,959
"1267",42500,63,64,1,959
"1268",42501,65,66,1,959
"1269",42502,63,63,0,959
"1270",42503,60,62,2,959
"1271",42504,59,67,8,959
"1272",42505,63,71,8,959
"1273",42506,64,71,7,959
"1274",42507,67,72,5,959
"1275",42508,65,73,8,959
"1276",42509,67,75,8,959
"1277",42510,69,73,4,959
"1278",42511,67,72,5,959
"1279",42512,58,68,10,959
"1280",42516,21,30,9,959
"1281",42535,75,75,0,959
"1282",42536,81,79,-2,959
"1283",42537,80,74,-6,959
"1284",42538,72,68,-4,959
"1285",42542,0,0,0,959
"1286",42544,64,70,6,959
"1287",42545,70,73,3,959
"1288",42546,71,72,1,959
"1289",42547,75,74,-1,959
"1290",42548,73,74,1,959
"1291",42549,69,70,1,959
"1292",42550,68,68,0,959
"1293",42551,57,55,-2,959
"1294",42552,54,53,-1,959
"1295",42553,48,50,2,959
"1296",42554,53,53,0,959
"1297",42555,55,56,1,959
"1298",42556,54,52,-2,959
"1299",42557,35,54,19,959
"1300",42558,36,51,15,959
"1301",42561,5,6,1,959
"1302",42562,5,6,1,959
"1303",43201,4,3,-1,959
"1304",43202,10,8,-2,959
"1305",43203,48,48,0,959
"1306",43204,54,50,-4,959
"1307",43205,51,50,-1,959
"1308",43206,56,53,-3,959
"1309",43207,56,52,-4,959
"1310",43208,58,54,-4,959
"1311",43209,60,58,-2,959
"1312",43210,60,58,-2,959
"1313",43211,62,66,4,959
"1314",43212,60,66,6,959
"1315",43213,59,64,5,959
"1316",43214,63,64,1,959
"1317",43215,63,65,2,959
"1318",43216,64,65,1,959
"1319",43217,62,65,3,959
"1320",43218,63,66,3,959
"1321",43219,63,63,0,959
"1322",43220,65,66,1,959
"1323",43221,65,64,-1,959
"1324",43222,64,62,-2,959
"1325",43223,64,63,-1,959
"1326",43224,62,67,5,959
"1327",43225,64,71,7,959
"1328",43226,67,72,5,959
"1329",43227,69,74,5,959
"1330",43228,73,74,1,959
"1331",43229,71,73,2,959
"1332",43230,70,74,4,959
"1333",43231,65,69,4,959
"1334",43232,67,71,4,959
"1335",43233,67,69,2,959
"1336",43234,70,72,2,959
"1337",43235,72,74,2,959
"1338",43236,77,77,0,959
"1339",43237,70,76,6,959
"1340",43253,74,77,3,959
"1341",43254,84,83,-1,959
"1342",43255,85,81,-4,959
"1343",43256,75,72,-3,959
"1344",43257,81,76,-5,959
"1345",43258,81,76,-5,959
"1346",43259,64,67,3,959
"1347",43260,78,76,-2,959
"1348",43261,82,81,-1,959
"1349",43262,81,81,0,959
"1350",43263,78,77,-1,959
"1351",43264,80,75,-5,959
"1352",43265,78,75,-3,959
"1353",43266,77,72,-5,959
"1354",43267,72,72,0,959
"1355",43268,66,68,2,959
"1356",43269,66,69,3,959
"1357",43270,66,66,0,959
"1358",43271,80,75,-5,959
"1359",43272,81,73,-8,959
"1360",43273,80,74,-6,959
"1361",43274,66,63,-3,959
"1362",43275,64,62,-2,959
"1363",43276,69,67,-2,959
"1364",43277,76,74,-2,959
"1365",43278,76,72,-4,959
"1366",43279,77,75,-2,959
"1367",43280,76,76,0,959
"1368",43281,78,77,-1,959
"1369",43282,63,67,4,959
"1370",43922,4,4,0,959
"1371",43923,14,13,-1,959
"1372",43924,50,50,0,959
"1373",43925,55,56,1,959
"1374",43926,56,54,-2,959
"1375",43927,57,54,-3,959
"1376",43928,58,54,-4,959
"1377",43929,61,61,0,959
"1378",43930,63,60,-3,959
"1379",43931,63,63,0,959
"1380",43932,64,66,2,959
"1381",43933,64,69,5,959
"1382",43934,65,69,4,959
"1383",43935,63,65,2,959
"1384",43936,64,65,1,959
"1385",43937,65,69,4,959
"1386",43938,66,68,2,959
"1387",43939,64,64,0,959
"1388",43940,66,66,0,959
"1389",43941,65,67,2,959
"1390",43942,65,68,3,959
"1391",43943,66,69,3,959
"1392",43944,65,68,3,959
"1393",43945,64,71,7,959
"1394",43946,65,69,4,959
"1395",43947,65,68,3,959
"1396",43948,66,70,4,959
"1397",43949,68,70,2,959
"1398",43950,66,67,1,959
"1399",43951,62,69,7,959
"1400",43952,62,67,5,959
"1401",43953,63,68,5,959
"1402",43954,64,68,4,959
"1403",43955,71,74,3,959
"1404",43956,74,75,1,959
"1405",43957,68,74,6,959
"1406",43959,11,13,2,959
"1407",43960,12,14,2,959
"1408",43964,3,2,-1,959
"1409",43972,76,71,-5,959
"1410",43973,81,81,0,959
"1411",43974,81,82,1,959
"1412",43975,79,77,-2,959
"1413",43976,79,75,-4,959
"1414",43977,83,78,-5,959
"1415",43978,82,78,-4,959
"1416",43979,83,83,0,959
"1417",43980,82,81,-1,959
"1418",43981,75,70,-5,959
"1419",43982,69,69,0,959
"1420",43983,71,69,-2,959
"1421",43984,72,70,-2,959
"1422",43985,75,73,-2,959
"1423",43986,68,67,-1,959
"1424",43987,70,70,0,959
"1425",43988,67,68,1,959
"1426",43989,55,55,0,959
"1427",43990,42,40,-2,959
"1428",43991,15,19,4,959
"1429",43992,11,14,3,959
"1430",43993,11,13,2,959
"1431",43994,11,13,2,959
"1432",43995,12,13,1,959
"1433",43996,43,44,1,959
"1434",43997,57,58,1,959
"1435",43998,59,59,0,959
"1436",43999,61,64,3,959
"1437",44000,67,68,1,959
"1438",44001,79,75,-4,959
"1439",44002,75,76,1,959
"1440",44003,73,76,3,959
"1441",44004,70,75,5,959
"1442",44007,15,26,11,959
"1443",44008,15,28,13,959
"1444",44009,6,13,7,959
"1445",44010,6,13,7,959
"1446",44643,5,3,-2,959
"1447",44644,22,16,-6,959
"1448",44645,26,36,10,959
"1449",44646,28,37,9,959
"1450",44647,60,46,-14,959
"1451",44648,61,43,-18,959
"1452",44649,65,57,-8,959
"1453",44650,66,59,-7,959
"1454",44651,66,63,-3,959
"1455",44652,61,59,-2,959
"1456",44653,63,64,1,959
"1457",44654,64,66,2,959
"1458",44655,66,70,4,959
"1459",44656,66,72,6,959
"1460",44657,64,69,5,959
"1461",44658,65,67,2,959
"1462",44659,65,65,0,959
"1463",44660,64,64,0,959
"1464",44661,64,66,2,959
"1465",44662,65,63,-2,959
"1466",44663,65,65,0,959
"1467",44664,66,69,3,959
"1468",44665,69,71,2,959
"1469",44666,68,72,4,959
"1470",44667,67,71,4,959
"1471",44668,67,70,3,959
"1472",44669,69,71,2,959
"1473",44670,69,69,0,959
"1474",44671,63,68,5,959
"1475",44672,64,68,4,959
"1476",44673,67,69,2,959
"1477",44674,68,70,2,959
"1478",44675,70,72,2,959
"1479",44676,81,79,-2,959
"1480",44677,82,80,-2,959
"1481",44678,80,80,0,959
"1482",44679,77,80,3,959
"1483",44680,78,79,1,959
"1484",44681,79,79,0,959
"1485",44682,79,81,2,959
"1486",44683,82,84,2,959
"1487",44684,80,84,4,959
"1488",44685,78,79,1,959
"1489",44686,76,78,2,959
"1490",44687,33,38,5,959
"1491",44693,85,85,0,959
"1492",44694,86,87,1,959
"1493",44695,84,84,0,959
"1494",44696,82,84,2,959
"1495",44697,86,86,0,959
"1496",44698,71,70,-1,959
"1497",44699,76,73,-3,959
"1498",44700,75,75,0,959
"1499",44701,73,72,-1,959
"1500",44702,71,71,0,959
"1501",44703,70,69,-1,959
"1502",44704,60,62,2,959
"1503",44705,27,28,1,959
"1504",44706,11,14,3,959
"1505",44707,8,11,3,959
"1506",44708,8,11,3,959
"1507",44709,6,9,3,959
"1508",44710,6,8,2,959
"1509",44711,6,8,2,959
"1510",44712,6,7,1,959
"1511",44713,6,7,1,959
"1512",44714,6,7,1,959
"1513",44715,7,7,0,959
"1514",44716,9,10,1,959
"1515",44717,13,14,1,959
"1516",44718,22,23,1,959
"1517",44719,49,45,-4,959
"1518",44720,69,67,-2,959
"1519",44721,70,71,1,959
"1520",44722,70,70,0,959
"1521",44723,73,73,0,959
"1522",44724,78,80,2,959
"1523",44725,79,82,3,959
"1524",44726,74,80,6,959
"1525",44727,83,82,-1,959
"1526",44728,85,85,0,959
"1527",44729,87,85,-2,959
"1528",44730,90,88,-2,959
"1529",44731,88,85,-3,959
"1530",45364,5,3,-2,959
"1531",45365,5,3,-2,959
"1532",45366,5,3,-2,959
"1533",45367,9,5,-4,959
"1534",45368,13,7,-6,959
"1535",45369,58,53,-5,959
"1536",45370,59,54,-5,959
"1537",45371,33,32,-1,959
"1538",45372,69,66,-3,959
"1539",45373,70,71,1,959
"1540",45374,67,71,4,959
"1541",45375,66,69,3,959
"1542",45376,66,68,2,959
"1543",45377,66,69,3,959
"1544",45378,67,72,5,959
"1545",45379,67,72,5,959
"1546",45380,67,70,3,959
"1547",45381,67,68,1,959
"1548",45382,65,67,2,959
"1549",45383,65,66,1,959
"1550",45384,66,69,3,959
"1551",45385,67,71,4,959
"1552",45386,66,71,5,959
"1553",45387,66,74,8,959
"1554",45388,71,76,5,959
"1555",45389,73,74,1,959
"1556",45390,70,74,4,959
"1557",45391,70,73,3,959
"1558",45392,68,70,2,959
"1559",45393,72,71,-1,959
"1560",45394,74,72,-2,959
"1561",45395,73,72,-1,959
"1562",45396,74,76,2,959
"1563",45397,80,81,1,959
"1564",45398,80,83,3,959
"1565",45399,80,83,3,959
"1566",45400,76,81,5,959
"1567",45401,80,84,4,959
"1568",45402,82,86,4,959
"1569",45403,85,86,1,959
"1570",45404,82,85,3,959
"1571",45405,79,81,2,959
"1572",45406,39,47,8,959
"1573",45411,85,87,2,959
"1574",45412,88,90,2,959
"1575",45413,85,86,1,959
"1576",45414,84,87,3,959
"1577",45415,86,85,-1,959
"1578",45416,85,84,-1,959
"1579",45417,85,85,0,959
"1580",45418,78,78,0,959
"1581",45419,74,75,1,959
"1582",45420,71,76,5,959
"1583",45421,74,77,3,959
"1584",45422,70,73,3,959
"1585",45423,74,75,1,959
"1586",45424,61,61,0,959
"1587",45425,11,14,3,959
"1588",45426,8,11,3,959
"1589",45427,8,11,3,959
"1590",45428,6,9,3,959
"1591",45429,6,9,3,959
"1592",45430,6,8,2,959
"1593",45431,6,8,2,959
"1594",45432,6,7,1,959
"1595",45433,6,7,1,959
"1596",45434,6,7,1,959
"1597",45435,6,7,1,959
"1598",45436,7,8,1,959
"1599",45437,7,8,1,959
"1600",45438,7,8,1,959
"1601",45439,8,8,0,959
"1602",45440,10,10,0,959
"1603",45441,50,46,-4,959
"1604",45442,71,70,-1,959
"1605",45443,80,80,0,959
"1606",45444,76,78,2,959
"1607",45445,71,72,1,959
"1608",45446,84,86,2,959
"1609",45447,87,90,3,959
"1610",45448,89,90,1,959
"1611",45449,89,90,1,959
"1612",45450,94,93,-1,959
"1613",45451,97,94,-3,959
"1614",45452,96,95,-1,959
"1615",45453,86,89,3,959
"1616",46085,4,3,-1,959
"1617",46086,4,3,-1,959
"1618",46087,4,3,-1,959
"1619",46088,5,3,-2,959
"1620",46089,5,4,-1,959
"1621",46090,5,4,-1,959
"1622",46091,9,8,-1,959
"1623",46092,49,50,1,959
"1624",46093,68,66,-2,959
"1625",46094,66,64,-2,959
"1626",46095,65,57,-8,959
"1627",46096,67,57,-10,959
"1628",46097,68,70,2,959
"1629",46098,68,69,1,959
"1630",46099,69,67,-2,959
"1631",46100,69,68,-1,959
"1632",46101,70,70,0,959
"1633",46102,66,65,-1,959
"1634",46103,69,69,0,959
"1635",46104,67,69,2,959
"1636",46105,70,70,0,959
"1637",46106,69,70,1,959
"1638",46107,73,70,-3,959
"1639",46108,73,72,-1,959
"1640",46109,79,76,-3,959
"1641",46110,77,73,-4,959
"1642",46111,78,74,-4,959
"1643",46112,76,74,-2,959
"1644",46113,78,73,-5,959
"1645",46114,78,74,-4,959
"1646",46115,79,77,-2,959
"1647",46116,79,77,-2,959
"1648",46117,80,79,-1,959
"1649",46118,82,80,-2,959
"1650",46119,83,81,-2,959
"1651",46120,83,83,0,959
"1652",46121,82,83,1,959
"1653",46122,82,84,2,959
"1654",46123,83,88,5,959
"1655",46124,83,85,2,959
"1656",46125,80,82,2,959
"1657",46128,12,11,-1,959
"1658",46129,86,88,2,959
"1659",46130,88,89,1,959
"1660",46131,90,92,2,959
"1661",46132,90,92,2,959
"1662",46133,87,91,4,959
"1663",46134,80,82,2,959
"1664",46135,84,83,-1,959
"1665",46136,86,87,1,959
"1666",46137,84,82,-2,959
"1667",46138,80,79,-1,959
"1668",46139,74,76,2,959
"1669",46140,76,79,3,959
"1670",46141,61,65,4,959
"1671",46142,53,61,8,959
"1672",46143,16,19,3,959
"1673",46144,11,15,4,959
"1674",46145,8,11,3,959
"1675",46146,6,8,2,959
"1676",46147,6,9,3,959
"1677",46148,6,9,3,959
"1678",46149,6,8,2,959
"1679",46150,6,7,1,959
"1680",46151,5,7,2,959
"1681",46152,6,7,1,959
"1682",46153,6,8,2,959
"1683",46154,6,8,2,959
"1684",46155,6,8,2,959
"1685",46156,6,8,2,959
"1686",46157,7,8,1,959
"1687",46158,8,9,1,959
"1688",46159,8,9,1,959
"1689",46160,8,9,1,959
"1690",46161,7,10,3,959
"1691",46162,9,12,3,959
"1692",46163,9,13,4,959
"1693",46164,48,49,1,959
"1694",46165,63,64,1,959
"1695",46166,65,65,0,959
"1696",46167,93,97,4,959
"1697",46168,95,95,0,959
"1698",46169,88,90,2,959
"1699",46170,92,91,-1,959
"1700",46171,94,91,-3,959
"1701",46172,93,91,-2,959
"1702",46173,95,92,-3,959
"1703",46174,90,88,-2,959
"1704",46175,7,15,8,959
"1705",46807,4,3,-1,959
"1706",46808,4,3,-1,959
"1707",46809,5,4,-1,959
"1708",46810,5,4,-1,959
"1709",46811,7,5,-2,959
"1710",46812,11,12,1,959
"1711",46813,66,64,-2,959
"1712",46814,70,67,-3,959
"1713",46815,67,58,-9,959
"1714",46816,64,55,-9,959
"1715",46817,67,57,-10,959
"1716",46818,74,75,1,959
"1717",46819,75,76,1,959
"1718",46820,73,72,-1,959
"1719",46821,74,74,0,959
"1720",46822,70,68,-2,959
"1721",46823,73,71,-2,959
"1722",46824,71,71,0,959
"1723",46825,72,71,-1,959
"1724",46826,72,72,0,959
"1725",46827,71,69,-2,959
"1726",46828,72,71,-1,959
"1727",46829,77,73,-4,959
"1728",46830,78,77,-1,959
"1729",46831,80,78,-2,959
"1730",46832,78,77,-1,959
"1731",46833,77,74,-3,959
"1732",46834,75,73,-2,959
"1733",46835,76,77,1,959
"1734",46836,77,80,3,959
"1735",46837,81,83,2,959
"1736",46838,83,83,0,959
"1737",46839,83,82,-1,959
"1738",46840,84,82,-2,959
"1739",46841,81,81,0,959
"1740",46842,83,82,-1,959
"1741",46843,85,87,2,959
"1742",46844,84,85,1,959
"1743",46845,9,8,-1,959
"1744",46847,82,86,4,959
"1745",46848,90,92,2,959
"1746",46849,91,94,3,959
"1747",46850,67,66,-1,959
"1748",46851,90,93,3,959
"1749",46852,82,84,2,959
"1750",46853,84,83,-1,959
"1751",46854,86,87,1,959
"1752",46855,87,89,2,959
"1753",46856,88,89,1,959
"1754",46857,83,85,2,959
"1755",46858,83,85,2,959
"1756",46859,76,77,1,959
"1757",46860,69,65,-4,959
"1758",46861,12,16,4,959
"1759",46862,8,11,3,959
"1760",46863,7,11,4,959
"1761",46864,7,11,4,959
"1762",46865,6,9,3,959
"1763",46866,6,8,2,959
"1764",46867,6,8,2,959
"1765",46868,6,8,2,959
"1766",46869,5,7,2,959
"1767",46870,5,7,2,959
"1768",46871,6,7,1,959
"1769",46872,5,7,2,959
"1770",46873,5,8,3,959
"1771",46874,5,8,3,959
"1772",46875,8,10,2,959
"1773",46876,8,10,2,959
"1774",46877,6,8,2,959
"1775",46878,7,8,1,959
"1776",46879,8,8,0,959
"1777",46880,8,9,1,959
"1778",46881,7,10,3,959
"1779",46882,7,10,3,959
"1780",46883,9,13,4,959
"1781",46884,9,14,5,959
"1782",46885,9,13,4,959
"1783",46886,9,13,4,959
"1784",46887,17,19,2,959
"1785",46888,84,87,3,959
"1786",46889,91,93,2,959
"1787",46890,89,88,-1,959
"1788",46891,98,95,-3,959
"1789",46892,100,99,-1,959
"1790",46893,100,98,-2,959
"1791",46894,97,100,3,959
"1792",46895,88,92,4,959
"1793",47527,3,3,0,959
"1794",47528,4,3,-1,959
"1795",47529,4,3,-1,959
"1796",47530,4,3,-1,959
"1797",47531,7,5,-2,959
"1798",47532,7,6,-1,959
"1799",47533,20,20,0,959
"1800",47534,54,52,-2,959
"1801",47535,66,69,3,959
"1802",47536,66,69,3,959
"1803",47537,68,67,-1,959
"1804",47538,64,62,-2,959
"1805",47539,68,68,0,959
"1806",47540,68,68,0,959
"1807",47541,77,78,1,959
"1808",47542,80,79,-1,959
"1809",47543,77,73,-4,959
"1810",47544,75,71,-4,959
"1811",47545,74,70,-4,959
"1812",47546,75,70,-5,959
"1813",47547,79,72,-7,959
"1814",47548,79,73,-6,959
"1815",47549,78,75,-3,959
"1816",47550,80,74,-6,959
"1817",47551,80,74,-6,959
"1818",47552,82,75,-7,959
"1819",47553,79,77,-2,959
"1820",47554,77,76,-1,959
"1821",47555,79,80,1,959
"1822",47556,79,81,2,959
"1823",47557,81,85,4,959
"1824",47558,82,85,3,959
"1825",47559,82,83,1,959
"1826",47560,87,86,-1,959
"1827",47561,85,85,0,959
"1828",47562,85,86,1,959
"1829",47563,87,86,-1,959
"1830",47564,57,61,4,959
"1831",47565,94,95,1,959
"1832",47566,95,95,0,959
"1833",47567,92,91,-1,959
"1834",47568,85,84,-1,959
"1835",47569,84,84,0,959
"1836",47570,89,89,0,959
"1837",47571,90,92,2,959
"1838",47572,88,88,0,959
"1839",47573,89,91,2,959
"1840",47574,91,91,0,959
"1841",47575,85,84,-1,959
"1842",47576,89,89,0,959
"1843",47577,86,84,-2,959
"1844",47578,55,51,-4,959
"1845",47579,12,14,2,959
"1846",47580,8,10,2,959
"1847",47581,7,10,3,959
"1848",47582,7,10,3,959
"1849",47583,5,9,4,959
"1850",47584,5,9,4,959
"1851",47585,6,9,3,959
"1852",47586,6,8,2,959
"1853",47587,6,10,4,959
"1854",47588,6,10,4,959
"1855",47589,7,10,3,959
"1856",47590,5,8,3,959
"1857",47591,6,8,2,959
"1858",47592,5,8,3,959
"1859",47593,5,7,2,959
"1860",47594,7,9,2,959
"1861",47595,8,10,2,959
"1862",47596,8,10,2,959
"1863",47597,7,8,1,959
"1864",47598,7,8,1,959
"1865",47599,7,8,1,959
"1866",47600,6,8,2,959
"1867",47601,6,10,4,959
"1868",47602,6,10,4,959
"1869",47603,6,9,3,959
"1870",47604,8,11,3,959
"1871",47605,8,12,4,959
"1872",47606,8,12,4,959
"1873",47607,10,13,3,959
"1874",47608,66,69,3,959
"1875",47609,103,101,-2,959
"1876",47610,95,93,-2,959
"1877",47611,102,101,-1,959
"1878",47612,102,104,2,959
"1879",47613,85,87,2,959
"1880",47614,92,95,3,959
"1881",47615,95,101,6,959
"1882",47616,95,100,5,959
"1883",48248,3,3,0,959
"1884",48249,4,3,-1,959
"1885",48250,4,3,-1,959
"1886",48251,5,3,-2,959
"1887",48252,5,4,-1,959
"1888",48253,5,4,-1,959
"1889",48254,7,6,-1,959
"1890",48255,14,13,-1,959
"1891",48256,14,13,-1,959
"1892",48257,28,31,3,959
"1893",48258,66,64,-2,959
"1894",48259,71,67,-4,959
"1895",48260,79,80,1,959
"1896",48261,81,81,0,959
"1897",48262,74,73,-1,959
"1898",48263,75,63,-12,959
"1899",48264,70,61,-9,959
"1900",48265,72,68,-4,959
"1901",48266,75,69,-6,959
"1902",48267,79,73,-6,959
"1903",48268,80,74,-6,959
"1904",48269,79,77,-2,959
"1905",48270,80,77,-3,959
"1906",48271,80,77,-3,959
"1907",48272,81,78,-3,959
"1908",48273,80,78,-2,959
"1909",48274,79,78,-1,959
"1910",48275,78,80,2,959
"1911",48276,80,84,4,959
"1912",48277,85,88,3,959
"1913",48278,87,91,4,959
"1914",48279,89,92,3,959
"1915",48280,87,89,2,959
"1916",48283,55,56,1,959
"1917",48284,95,93,-2,959
"1918",48285,96,95,-1,959
"1919",48286,95,95,0,959
"1920",48287,94,96,2,959
"1921",48288,85,85,0,959
"1922",48289,89,87,-2,959
"1923",48290,87,90,3,959
"1924",48291,93,98,5,959
"1925",48292,95,96,1,959
"1926",48293,90,91,1,959
"1927",48294,90,94,4,959
"1928",48295,89,88,-1,959
"1929",48296,72,69,-3,959
"1930",48297,12,12,0,959
"1931",48298,8,8,0,959
"1932",48299,6,8,2,959
"1933",48300,6,8,2,959
"1934",48301,5,8,3,959
"1935",48302,5,8,3,959
"1936",48303,5,9,4,959
"1937",48304,5,9,4,959
"1938",48305,4,8,4,959
"1939",48306,4,8,4,959
"1940",48307,4,8,4,959
"1941",48308,6,10,4,959
"1942",48309,6,10,4,959
"1943",48310,6,10,4,959
"1944",48311,7,10,3,959
"1945",48312,7,10,3,959
"1946",48313,7,9,2,959
"1947",48314,7,9,2,959
"1948",48316,12,14,2,959
"1949",48317,9,10,1,959
"1950",48318,7,8,1,959
"1951",48319,6,8,2,959
"1952",48320,6,10,4,959
"1953",48321,6,10,4,959
"1954",48322,6,10,4,959
"1955",48323,8,11,3,959
"1956",48324,8,11,3,959
"1957",48325,8,12,4,959
"1958",48326,8,12,4,959
"1959",48327,10,13,3,959
"1960",48328,10,13,3,959
"1961",48329,81,78,-3,959
"1962",48330,95,90,-5,959
"1963",48331,105,107,2,959
"1964",48332,106,107,1,959
"1965",48333,103,105,2,959
"1966",48334,101,104,3,959
"1967",48335,100,105,5,959
"1968",48336,99,103,4,959
"1969",48337,91,96,5,959
"1970",48338,44,52,8,959
"1971",48948,2,3,1,959
"1972",48949,2,3,1,959
"1973",48950,2,3,1,959
"1974",48951,2,3,1,959
"1975",48952,2,3,1,959
"1976",48968,3,2,-1,959
"1977",48969,3,2,-1,959
"1978",48970,3,2,-1,959
"1979",48971,3,2,-1,959
"1980",48972,3,3,0,959
"1981",48973,3,3,0,959
"1982",48974,4,3,-1,959
"1983",48975,4,3,-1,959
"1984",48976,4,3,-1,959
"1985",48977,6,6,0,959
"1986",48978,6,6,0,959
"1987",48979,7,7,0,959
"1988",48980,12,13,1,959
"1989",48981,12,13,1,959
"1990",48982,11,12,1,959
"1991",48983,65,69,4,959
"1992",48984,65,69,4,959
"1993",48985,75,72,-3,959
"1994",48986,73,69,-4,959
"1995",48987,78,71,-7,959
"1996",48988,79,73,-6,959
"1997",48989,79,75,-4,959
"1998",48990,79,75,-4,959
"1999",48991,83,78,-5,959
"2000",48992,83,81,-2,959
"2001",48993,79,76,-3,959
"2002",48994,86,80,-6,959
"2003",48995,89,85,-4,959
"2004",48996,88,87,-1,959
"2005",48997,79,82,3,959
"2006",48998,83,86,3,959
"2007",48999,93,94,1,959
"2008",49000,93,94,1,959
"2009",49001,95,93,-2,959
"2010",49002,97,94,-3,959
"2011",49003,98,96,-2,959
"2012",49004,100,98,-2,959
"2013",49005,95,97,2,959
"2014",49006,93,95,2,959
"2015",49007,93,91,-2,959
"2016",49008,84,84,0,959
"2017",49009,96,96,0,959
"2018",49010,97,98,1,959
"2019",49011,83,83,0,959
"2020",49012,65,71,6,959
"2021",49013,56,59,3,959
"2022",49014,48,49,1,959
"2023",49015,8,9,1,959
"2024",49016,6,7,1,959
"2025",49017,6,8,2,959
"2026",49018,6,8,2,959
"2027",49019,6,8,2,959
"2028",49020,6,8,2,959
"2029",49021,5,8,3,959
"2030",49022,5,8,3,959
"2031",49023,5,8,3,959
"2032",49024,4,8,4,959
"2033",49025,4,8,4,959
"2034",49026,4,8,4,959
"2035",49027,4,8,4,959
"2036",49037,10,11,1,959
"2037",49038,5,7,2,959
"2038",49039,5,8,3,959
"2039",49040,6,9,3,959
"2040",49041,6,10,4,959
"2041",49042,6,10,4,959
"2042",49043,8,11,3,959
"2043",49044,8,11,3,959
"2044",49045,8,11,3,959
"2045",49046,8,11,3,959
"2046",49047,8,11,3,959
"2047",49048,8,11,3,959
"2048",49049,14,16,2,959
"2049",49050,73,72,-1,959
"2050",49051,107,110,3,959
"2051",49052,104,107,3,959
"2052",49053,99,103,4,959
"2053",49054,93,98,5,959
"2054",49055,91,96,5,959
"2055",49056,101,103,2,959
"2056",49057,101,104,3,959
"2057",49058,101,106,5,959
"2058",49059,101,104,3,959
"2059",49060,50,55,5,959
"2060",49666,2,3,1,959
"2061",49667,2,3,1,959
"2062",49668,2,3,1,959
"2063",49669,2,3,1,959
"2064",49670,2,3,1,959
"2065",49671,2,3,1,959
"2066",49672,2,3,1,959
"2067",49673,3,3,0,959
"2068",49674,3,3,0,959
"2069",49675,3,3,0,959
"2070",49676,3,3,0,959
"2071",49681,2,2,0,959
"2072",49682,2,2,0,959
"2073",49683,2,2,0,959
"2074",49684,2,2,0,959
"2075",49685,2,2,0,959
"2076",49686,2,2,0,959
"2077",49687,3,2,-1,959
"2078",49688,3,2,-1,959
"2079",49689,3,2,-1,959
"2080",49690,3,2,-1,959
"2081",49691,3,2,-1,959
"2082",49692,3,3,0,959
"2083",49693,3,3,0,959
"2084",49694,3,3,0,959
"2085",49695,4,3,-1,959
"2086",49696,4,3,-1,959
"2087",49697,4,4,0,959
"2088",49698,6,6,0,959
"2089",49699,7,6,-1,959
"2090",49700,7,6,-1,959
"2091",49701,7,6,-1,959
"2092",49702,7,6,-1,959
"2093",49703,12,10,-2,959
"2094",49704,54,53,-1,959
"2095",49705,70,61,-9,959
"2096",49706,72,62,-10,959
"2097",49707,75,71,-4,959
"2098",49708,76,71,-5,959
"2099",49709,79,74,-5,959
"2100",49710,79,74,-5,959
"2101",49711,82,81,-1,959
"2102",49712,92,90,-2,959
"2103",49713,89,87,-2,959
"2104",49714,90,87,-3,959
"2105",49715,84,81,-3,959
"2106",49716,87,88,1,959
"2107",49717,93,90,-3,959
"2108",49718,95,92,-3,959
"2109",49719,96,94,-2,959
"2110",49720,96,94,-2,959
"2111",49721,96,94,-2,959
"2112",49722,96,94,-2,959
"2113",49723,97,97,0,959
"2114",49724,89,83,-6,959
"2115",49725,88,89,1,959
"2116",49726,91,93,2,959
"2117",49727,89,92,3,959
"2118",49728,77,78,1,959
"2119",49729,67,68,1,959
"2120",49730,25,18,-7,959
"2121",49731,11,15,4,959
"2122",49732,11,15,4,959
"2123",49733,5,6,1,959
"2124",49734,5,7,2,959
"2125",49735,6,7,1,959
"2126",49736,6,8,2,959
"2127",49737,6,8,2,959
"2128",49738,6,8,2,959
"2129",49739,6,8,2,959
"2130",49740,6,8,2,959
"2131",49741,5,8,3,959
"2132",49742,5,8,3,959
"2133",49743,4,8,4,959
"2134",49744,4,8,4,959
"2135",49745,4,8,4,959
"2136",49746,4,8,4,959
"2137",49758,7,9,2,959
"2138",49759,5,8,3,959
"2139",49760,7,11,4,959
"2140",49761,7,12,5,959
"2141",49762,6,10,4,959
"2142",49763,8,11,3,959
"2143",49764,8,11,3,959
"2144",49765,8,11,3,959
"2145",49766,8,11,3,959
"2146",49767,8,11,3,959
"2147",49768,8,11,3,959
"2148",49769,10,12,2,959
"2149",49770,16,18,2,959
"2150",49771,79,78,-1,959
"2151",49772,101,101,0,959
"2152",49773,104,108,4,959
"2153",49774,99,105,6,959
"2154",49775,86,90,4,959
"2155",49776,99,103,4,959
"2156",49777,100,103,3,959
"2157",49778,102,103,1,959
"2158",49779,97,102,5,959
"2159",49780,98,103,5,959
"2160",49781,95,100,5,959
"2161",50385,2,3,1,959
"2162",50386,2,3,1,959
"2163",50387,2,3,1,959
"2164",50388,2,3,1,959
"2165",50389,2,3,1,959
"2166",50390,2,3,1,959
"2167",50391,2,3,1,959
"2168",50392,2,3,1,959
"2169",50393,3,4,1,959
"2170",50394,4,4,0,959
"2171",50395,4,4,0,959
"2172",50396,4,4,0,959
"2173",50397,4,3,-1,959
"2174",50398,4,3,-1,959
"2175",50399,1,2,1,959
"2176",50400,2,2,0,959
"2177",50401,2,2,0,959
"2178",50402,2,2,0,959
"2179",50403,2,2,0,959
"2180",50404,2,2,0,959
"2181",50405,2,1,-1,959
"2182",50406,2,1,-1,959
"2183",50407,2,2,0,959
"2184",50408,2,2,0,959
"2185",50409,1,2,1,959
"2186",50410,1,2,1,959
"2187",50411,1,2,1,959
"2188",50412,1,3,2,959
"2189",50413,1,3,2,959
"2190",50414,1,3,2,959
"2191",50415,3,3,0,959
"2192",50416,3,3,0,959
"2193",50417,4,3,-1,959
"2194",50418,4,3,-1,959
"2195",50419,7,5,-2,959
"2196",50420,7,5,-2,959
"2197",50421,7,5,-2,959
"2198",50422,10,9,-1,959
"2199",50423,12,10,-2,959
"2200",50424,12,9,-3,959
"2201",50425,34,30,-4,959
"2202",50426,69,64,-5,959
"2203",50427,75,71,-4,959
"2204",50428,81,77,-4,959
"2205",50429,81,79,-2,959
"2206",50430,86,82,-4,959
"2207",50431,90,90,0,959
"2208",50432,90,90,0,959
"2209",50433,93,91,-2,959
"2210",50434,95,93,-2,959
"2211",50435,95,93,-2,959
"2212",50436,95,94,-1,959
"2213",50437,96,96,0,959
"2214",50438,97,97,0,959
"2215",50439,97,97,0,959
"2216",50440,97,94,-3,959
"2217",50441,98,96,-2,959
"2218",50442,99,97,-2,959
"2219",50443,99,96,-3,959
"2220",50444,86,82,-4,959
"2221",50445,70,69,-1,959
"2222",50446,69,67,-2,959
"2223",50447,14,11,-3,959
"2224",50448,12,10,-2,959
"2225",50449,7,8,1,959
"2226",50450,5,6,1,959
"2227",50451,5,5,0,959
"2228",50452,5,5,0,959
"2229",50453,6,7,1,959
"2230",50454,6,8,2,959
"2231",50455,6,8,2,959
"2232",50456,6,8,2,959
"2233",50457,5,8,3,959
"2234",50458,6,10,4,959
"2235",50459,9,13,4,959
"2236",50460,9,13,4,959
"2237",50461,6,10,4,959
"2238",50462,6,10,4,959
"2239",50463,4,8,4,959
"2240",50464,4,8,4,959
"2241",50479,5,9,4,959
"2242",50480,5,9,4,959
"2243",50481,5,10,5,959
"2244",50482,7,12,5,959
"2245",50483,7,11,4,959
"2246",50484,7,11,4,959
"2247",50485,7,11,4,959
"2248",50486,12,14,2,959
"2249",50487,12,14,2,959
"2250",50488,9,11,2,959
"2251",50489,10,12,2,959
"2252",50490,10,12,2,959
"2253",50491,16,17,1,959
"2254",50492,75,76,1,959
"2255",50493,111,113,2,959
"2256",50494,108,109,1,959
"2257",50495,106,109,3,959
"2258",50496,107,108,1,959
"2259",50497,109,109,0,959
"2260",50498,109,109,0,959
"2261",50499,104,106,2,959
"2262",50500,103,105,2,959
"2263",51103,2,3,1,959
"2264",51104,2,3,1,959
"2265",51105,2,3,1,959
"2266",51106,2,3,1,959
"2267",51107,2,3,1,959
"2268",51108,2,3,1,959
"2269",51109,2,3,1,959
"2270",51110,2,3,1,959
"2271",51111,2,3,1,959
"2272",51112,2,3,1,959
"2273",51113,9,10,1,959
"2274",51114,9,10,1,959
"2275",51115,4,4,0,959
"2276",51116,4,4,0,959
"2277",51117,10,9,-1,959
"2278",51118,15,14,-1,959
"2279",51119,14,15,1,959
"2280",51120,2,3,1,959
"2281",51121,6,7,1,959
"2282",51122,2,2,0,959
"2283",51123,2,2,0,959
"2284",51124,2,2,0,959
"2285",51125,2,1,-1,959
"2286",51126,2,1,-1,959
"2287",51127,2,2,0,959
"2288",51128,2,2,0,959
"2289",51129,1,2,1,959
"2290",51130,1,2,1,959
"2291",51131,1,2,1,959
"2292",51132,1,3,2,959
"2293",51133,1,3,2,959
"2294",51134,2,3,1,959
"2295",51135,3,3,0,959
"2296",51136,3,3,0,959
"2297",51137,4,3,-1,959
"2298",51138,6,5,-1,959
"2299",51139,7,5,-2,959
"2300",51140,7,5,-2,959
"2301",51141,7,5,-2,959
"2302",51142,7,6,-1,959
"2303",51143,14,12,-2,959
"2304",51144,14,11,-3,959
"2305",51145,24,17,-7,959
"2306",51146,33,30,-3,959
"2307",51147,99,97,-2,959
"2308",51148,100,96,-4,959
"2309",51149,98,97,-1,959
"2310",51150,95,94,-1,959
"2311",51151,91,90,-1,959
"2312",51152,87,86,-1,959
"2313",51153,79,78,-1,959
"2314",51154,95,92,-3,959
"2315",51155,101,100,-1,959
"2316",51156,102,102,0,959
"2317",51157,96,95,-1,959
"2318",51158,90,90,0,959
"2319",51159,88,88,0,959
"2320",51160,89,88,-1,959
"2321",51161,90,88,-2,959
"2322",51162,80,76,-4,959
"2323",51163,26,25,-1,959
"2324",51164,12,8,-4,959
"2325",51165,9,5,-4,959
"2326",51166,8,6,-2,959
"2327",51167,6,4,-2,959
"2328",51168,6,4,-2,959
"2329",51169,5,6,1,959
"2330",51170,5,6,1,959
"2331",51171,5,5,0,959
"2332",51172,5,5,0,959
"2333",51173,5,7,2,959
"2334",51174,5,8,3,959
"2335",51175,5,8,3,959
"2336",51176,5,8,3,959
"2337",51177,4,8,4,959
"2338",51178,4,8,4,959
"2339",51179,6,10,4,959
"2340",51180,6,10,4,959
"2341",51181,6,10,4,959
"2342",51182,6,10,4,959
"2343",51201,5,10,5,959
"2344",51202,5,10,5,959
"2345",51203,5,9,4,959
"2346",51204,5,9,4,959
"2347",51205,7,11,4,959
"2348",51206,8,11,3,959
"2349",51207,10,12,2,959
"2350",51208,10,12,2,959
"2351",51209,10,12,2,959
"2352",51210,10,12,2,959
"2353",51211,11,12,1,959
"2354",51212,19,20,1,959
"2355",51213,78,80,2,959
"2356",51214,108,109,1,959
"2357",51215,106,109,3,959
"2358",51216,106,109,3,959
"2359",51217,107,108,1,959
"2360",51822,2,3,1,959
"2361",51823,2,3,1,959
"2362",51824,2,3,1,959
"2363",51825,3,3,0,959
"2364",51826,3,3,0,959
"2365",51827,3,3,0,959
"2366",51828,3,3,0,959
"2367",51829,2,3,1,959
"2368",51830,2,3,1,959
"2369",51831,2,3,1,959
"2370",51832,2,3,1,959
"2371",51833,2,3,1,959
"2372",51834,2,3,1,959
"2373",51835,3,3,0,959
"2374",51836,3,3,0,959
"2375",51837,4,2,-2,959
"2376",51838,5,4,-1,959
"2377",51839,7,8,1,959
"2378",51840,6,7,1,959
"2379",51841,5,5,0,959
"2380",51842,3,4,1,959
"2381",51843,2,2,0,959
"2382",51844,2,1,-1,959
"2383",51845,1,1,0,959
"2384",51846,1,1,0,959
"2385",51847,1,2,1,959
"2386",51848,1,2,1,959
"2387",51849,3,2,-1,959
"2388",51850,3,2,-1,959
"2389",51851,3,2,-1,959
"2390",51852,3,2,-1,959
"2391",51853,3,3,0,959
"2392",51854,3,3,0,959
"2393",51855,2,3,1,959
"2394",51856,4,5,1,959
"2395",51857,4,5,1,959
"2396",51858,4,5,1,959
"2397",51859,4,5,1,959
"2398",51860,4,6,2,959
"2399",51861,8,7,-1,959
"2400",51862,12,10,-2,959
"2401",51863,19,18,-1,959
"2402",51864,97,93,-4,959
"2403",51865,98,96,-2,959
"2404",51866,97,97,0,959
"2405",51867,89,90,1,959
"2406",51868,93,92,-1,959
"2407",51869,93,93,0,959
"2408",51870,91,91,0,959
"2409",51871,91,90,-1,959
"2410",51872,91,89,-2,959
"2411",51873,87,85,-2,959
"2412",51874,84,83,-1,959
"2413",51875,16,16,0,959
"2414",51876,11,11,0,959
"2415",51877,12,11,-1,959
"2416",51878,12,11,-1,959
"2417",51879,7,5,-2,959
"2418",51880,7,5,-2,959
"2419",51881,6,3,-3,959
"2420",51882,6,3,-3,959
"2421",51883,5,5,0,959
"2422",51884,5,5,0,959
"2423",51885,5,5,0,959
"2424",51886,5,6,1,959
"2425",51887,5,5,0,959
"2426",51888,5,5,0,959
"2427",51889,5,6,1,959
"2428",51890,5,7,2,959
"2429",51891,5,7,2,959
"2430",51892,5,7,2,959
"2431",51893,5,7,2,959
"2432",51894,5,8,3,959
"2433",51895,5,8,3,959
"2434",51896,4,8,4,959
"2435",51897,4,8,4,959
"2436",51898,4,8,4,959
"2437",51899,4,8,4,959
"2438",51900,4,8,4,959
"2439",51922,5,10,5,959
"2440",51923,5,10,5,959
"2441",51924,5,10,5,959
"2442",51925,6,10,4,959
"2443",51926,9,12,3,959
"2444",51927,13,16,3,959
"2445",51928,14,16,2,959
"2446",51929,15,17,2,959
"2447",52541,4,5,1,959
"2448",52542,2,3,1,959
"2449",52543,3,3,0,959
"2450",52544,3,3,0,959
"2451",52545,3,3,0,959
"2452",52546,3,3,0,959
"2453",52547,3,3,0,959
"2454",52548,3,3,0,959
"2455",52549,2,3,1,959
"2456",52550,2,3,1,959
"2457",52551,2,3,1,959
"2458",52552,2,3,1,959
"2459",52553,3,2,-1,959
"2460",52554,3,2,-1,959
"2461",52555,3,2,-1,959
"2462",52556,3,2,-1,959
"2463",52557,3,2,-1,959
"2464",52558,3,2,-1,959
"2465",52559,3,2,-1,959
"2466",52560,5,4,-1,959
"2467",52561,5,5,0,959
"2468",52562,4,4,0,959
"2469",52563,3,2,-1,959
"2470",52564,3,1,-2,959
"2471",52565,1,1,0,959
"2472",52566,2,1,-1,959
"2473",52567,2,2,0,959
"2474",52568,2,2,0,959
"2475",52569,3,2,-1,959
"2476",52570,3,2,-1,959
"2477",52571,3,2,-1,959
"2478",52572,3,2,-1,959
"2479",52573,5,4,-1,959
"2480",52574,5,5,0,959
"2481",52575,4,5,1,959
"2482",52576,5,6,1,959
"2483",52577,9,10,1,959
"2484",52578,16,17,1,959
"2485",52579,16,18,2,959
"2486",52580,66,65,-1,959
"2487",52581,68,66,-2,959
"2488",52582,61,62,1,959
"2489",52583,88,86,-2,959
"2490",52584,94,91,-3,959
"2491",52585,97,93,-4,959
"2492",52586,97,97,0,959
"2493",52587,98,99,1,959
"2494",52588,96,97,1,959
"2495",52589,69,68,-1,959
"2496",52590,14,13,-1,959
"2497",52591,7,5,-2,959
"2498",52592,7,5,-2,959
"2499",52593,7,5,-2,959
"2500",52594,5,3,-2,959
"2501",52595,4,4,0,959
"2502",52596,4,4,0,959
"2503",52597,5,4,-1,959
"2504",52598,5,4,-1,959
"2505",52599,5,3,-2,959
"2506",52600,5,3,-2,959
"2507",52601,6,3,-3,959
"2508",52602,6,3,-3,959
"2509",52603,5,5,0,959
"2510",52604,5,5,0,959
"2511",52605,5,5,0,959
"2512",52606,5,6,1,959
"2513",52607,5,5,0,959
"2514",52608,5,5,0,959
"2515",52609,5,6,1,959
"2516",52610,5,7,2,959
"2517",52611,4,7,3,959
"2518",52612,4,7,3,959
"2519",52613,4,7,3,959
"2520",52614,3,7,4,959
"2521",52615,3,7,4,959
"2522",52616,3,7,4,959
"2523",52617,3,7,4,959
"2524",52618,4,8,4,959
"2525",52643,5,10,5,959
"2526",53259,3,3,0,959
"2527",53260,3,3,0,959
"2528",53261,4,5,1,959
"2529",53262,25,26,1,959
"2530",53263,25,26,1,959
"2531",53264,20,24,4,959
"2532",53265,20,20,0,959
"2533",53266,24,25,1,959
"2534",53267,25,25,0,959
"2535",53268,3,3,0,959
"2536",53269,2,3,1,959
"2537",53270,2,3,1,959
"2538",53271,2,3,1,959
"2539",53272,2,3,1,959
"2540",53273,3,2,-1,959
"2541",53274,3,2,-1,959
"2542",53275,4,3,-1,959
"2543",53276,4,3,-1,959
"2544",53277,3,2,-1,959
"2545",53278,3,2,-1,959
"2546",53279,3,3,0,959
"2547",53280,4,4,0,959
"2548",53281,22,22,0,959
"2549",53282,22,24,2,959
"2550",53283,3,1,-2,959
"2551",53284,3,1,-2,959
"2552",53285,2,1,-1,959
"2553",53286,2,1,-1,959
"2554",53287,2,2,0,959
"2555",53288,2,2,0,959
"2556",53289,2,2,0,959
"2557",53290,2,2,0,959
"2558",53291,6,5,-1,959
"2559",53292,12,9,-3,959
"2560",53293,55,54,-1,959
"2561",53294,55,54,-1,959
"2562",53295,31,30,-1,959
"2563",53296,60,58,-2,959
"2564",53297,60,58,-2,959
"2565",53298,87,83,-4,959
"2566",53299,88,86,-2,959
"2567",53300,88,86,-2,959
"2568",53301,86,82,-4,959
"2569",53302,91,87,-4,959
"2570",53303,92,87,-5,959
"2571",53304,90,84,-6,959
"2572",53305,24,22,-2,959
"2573",53306,21,19,-2,959
"2574",53307,8,6,-2,959
"2575",53308,5,3,-2,959
"2576",53309,5,3,-2,959
"2577",53310,5,3,-2,959
"2578",53311,5,3,-2,959
"2579",53312,5,3,-2,959
"2580",53313,5,3,-2,959
"2581",53314,5,3,-2,959
"2582",53315,5,3,-2,959
"2583",53316,5,3,-2,959
"2584",53317,4,4,0,959
"2585",53318,4,4,0,959
"2586",53319,4,5,1,959
"2587",53320,4,5,1,959
"2588",53321,5,5,0,959
"2589",53322,5,5,0,959
"2590",53323,5,4,-1,959
"2591",53324,5,4,-1,959
"2592",53325,5,4,-1,959
"2593",53326,5,4,-1,959
"2594",53327,4,7,3,959
"2595",53328,4,7,3,959
"2596",53329,4,7,3,959
"2597",53330,4,7,3,959
"2598",53331,4,7,3,959
"2599",53332,3,6,3,959
"2600",53333,3,6,3,959
"2601",53334,3,7,4,959
"2602",53335,3,7,4,959
"2603",53336,3,7,4,959
"2604",53978,3,3,0,959
"2605",53979,3,3,0,959
"2606",53980,3,3,0,959
"2607",53981,4,4,0,959
"2608",53982,14,14,0,959
"2609",53983,14,14,0,959
"2610",53984,7,7,0,959
"2611",53985,25,26,1,959
"2612",53986,24,24,0,959
"2613",53987,23,24,1,959
"2614",53988,22,23,1,959
"2615",53989,23,23,0,959
"2616",53990,18,18,0,959
"2617",53991,15,16,1,959
"2618",53992,7,5,-2,959
"2619",53993,2,3,1,959
"2620",53994,2,3,1,959
"2621",53995,2,3,1,959
"2622",53996,3,3,0,959
"2623",53997,2,3,1,959
"2624",53998,2,3,1,959
"2625",53999,4,5,1,959
"2626",54000,11,15,4,959
"2627",54001,10,11,1,959
"2628",54002,6,7,1,959
"2629",54003,3,1,-2,959
"2630",54004,3,1,-2,959
"2631",54005,2,1,-1,959
"2632",54006,3,2,-1,959
"2633",54007,29,28,-1,959
"2634",54008,27,27,0,959
"2635",54009,28,28,0,959
"2636",54010,30,30,0,959
"2637",54011,80,81,1,959
"2638",54012,80,80,0,959
"2639",54013,82,81,-1,959
"2640",54014,81,80,-1,959
"2641",54015,81,81,0,959
"2642",54016,80,79,-1,959
"2643",54017,72,71,-1,959
"2644",54018,76,73,-3,959
"2645",54019,75,71,-4,959
"2646",54020,66,62,-4,959
"2647",54021,62,60,-2,959
"2648",54022,36,33,-3,959
"2649",54023,8,8,0,959
"2650",54024,7,6,-1,959
"2651",54025,5,4,-1,959
"2652",54026,5,4,-1,959
"2653",54027,5,4,-1,959
"2654",54028,5,4,-1,959
"2655",54029,5,4,-1,959
"2656",54030,5,4,-1,959
"2657",54031,5,4,-1,959
"2658",54032,5,4,-1,959
"2659",54033,5,4,-1,959
"2660",54034,5,4,-1,959
"2661",54035,4,4,0,959
"2662",54036,3,4,1,959
"2663",54037,4,5,1,959
"2664",54038,4,5,1,959
"2665",54039,4,5,1,959
"2666",54040,4,5,1,959
"2667",54041,4,4,0,959
"2668",54042,5,5,0,959
"2669",54043,4,4,0,959
"2670",54044,4,5,1,959
"2671",54045,4,4,0,959
"2672",54046,4,4,0,959
"2673",54047,4,6,2,959
"2674",54048,4,6,2,959
"2675",54049,3,6,3,959
"2676",54050,3,6,3,959
"2677",54051,3,6,3,959
"2678",54052,3,6,3,959
"2679",54697,3,3,0,959
"2680",54698,3,3,0,959
"2681",54699,3,3,0,959
"2682",54700,3,3,0,959
"2683",54701,3,3,0,959
"2684",54702,3,3,0,959
"2685",54703,2,3,1,959
"2686",54704,3,3,0,959
"2687",54705,4,3,-1,959
"2688",54706,5,6,1,959
"2689",54707,24,24,0,959
"2690",54708,23,23,0,959
"2691",54709,20,21,1,959
"2692",54710,17,17,0,959
"2693",54711,20,25,5,959
"2694",54712,21,25,4,959
"2695",54713,22,26,4,959
"2696",54714,23,26,3,959
"2697",54715,23,26,3,959
"2698",54716,22,25,3,959
"2699",54717,23,26,3,959
"2700",54718,24,27,3,959
"2701",54719,25,27,2,959
"2702",54720,11,15,4,959
"2703",54721,19,19,0,959
"2704",54722,31,30,-1,959
"2705",54723,30,27,-3,959
"2706",54724,30,27,-3,959
"2707",54725,45,39,-6,959
"2708",54726,46,40,-6,959
"2709",54727,61,42,-19,959
"2710",54728,61,44,-17,959
"2711",54729,67,43,-24,959
"2712",54730,71,48,-23,959
"2713",54731,81,81,0,959
"2714",54732,82,80,-2,959
"2715",54733,74,72,-2,959
"2716",54734,76,74,-2,959
"2717",54735,76,75,-1,959
"2718",54736,63,62,-1,959
"2719",54737,63,63,0,959
"2720",54738,6,6,0,959
"2721",54739,3,4,1,959
"2722",54740,3,4,1,959
"2723",54741,3,4,1,959
"2724",54742,3,3,0,959
"2725",54743,6,4,-2,959
"2726",54744,6,4,-2,959
"2727",54745,5,4,-1,959
"2728",54746,5,4,-1,959
"2729",54747,5,4,-1,959
"2730",54748,5,4,-1,959
"2731",54749,5,5,0,959
"2732",54750,5,5,0,959
"2733",54751,5,6,1,959
"2734",54752,5,6,1,959
"2735",54753,5,6,1,959
"2736",54754,5,5,0,959
"2737",54755,4,5,1,959
"2738",54756,4,5,1,959
"2739",54757,4,5,1,959
"2740",54758,4,5,1,959
"2741",54759,4,5,1,959
"2742",54760,4,5,1,959
"2743",54761,4,7,3,959
"2744",54762,5,7,2,959
"2745",54763,5,7,2,959
"2746",54764,5,7,2,959
"2747",54765,5,7,2,959
"2748",54766,5,7,2,959
"2749",54767,4,7,3,959
"2750",54768,4,7,3,959
"2751",55416,4,4,0,959
"2752",55417,4,4,0,959
"2753",55418,4,4,0,959
"2754",55419,4,3,-1,959
"2755",55420,4,3,-1,959
"2756",55421,2,3,1,959
"2757",55422,2,3,1,959
"2758",55423,2,3,1,959
"2759",55424,2,3,1,959
"2760",55425,3,3,0,959
"2761",55426,3,3,0,959
"2762",55427,3,4,1,959
"2763",55428,3,4,1,959
"2764",55429,3,4,1,959
"2765",55430,8,9,1,959
"2766",55431,20,25,5,959
"2767",55432,23,27,4,959
"2768",55433,23,27,4,959
"2769",55434,23,26,3,959
"2770",55435,22,25,3,959
"2771",55436,22,25,3,959
"2772",55437,23,26,3,959
"2773",55438,23,26,3,959
"2774",55439,23,26,3,959
"2775",55440,10,13,3,959
"2776",55441,20,22,2,959
"2777",55442,26,27,1,959
"2778",55443,32,29,-3,959
"2779",55444,33,30,-3,959
"2780",55445,13,11,-2,959
"2781",55446,12,5,-7,959
"2782",55447,14,7,-7,959
"2783",55448,14,7,-7,959
"2784",55449,7,5,-2,959
"2785",55450,5,4,-1,959
"2786",55451,3,3,0,959
"2787",55452,3,3,0,959
"2788",55453,4,3,-1,959
"2789",55454,4,3,-1,959
"2790",55455,4,3,-1,959
"2791",55456,4,3,-1,959
"2792",55457,4,4,0,959
"2793",55458,4,4,0,959
"2794",55459,3,4,1,959
"2795",55460,3,4,1,959
"2796",55461,3,4,1,959
"2797",55462,3,3,0,959
"2798",55463,6,4,-2,959
"2799",55464,5,4,-1,959
"2800",55465,5,4,-1,959
"2801",55466,5,4,-1,959
"2802",55467,5,4,-1,959
"2803",55468,5,3,-2,959
"2804",55469,5,4,-1,959
"2805",55470,5,4,-1,959
"2806",55471,5,5,0,959
"2807",55472,5,5,0,959
"2808",55473,4,5,1,959
"2809",55474,4,5,1,959
"2810",55475,4,5,1,959
"2811",55476,4,5,1,959
"2812",55477,4,5,1,959
"2813",55478,4,5,1,959
"2814",55479,4,5,1,959
"2815",55480,4,5,1,959
"2816",55481,4,7,3,959
"2817",55482,4,7,3,959
"2818",55483,4,7,3,959
"2819",55484,4,7,3,959
"2820",56136,4,4,0,959
"2821",56137,4,4,0,959
"2822",56138,4,4,0,959
"2823",56139,4,3,-1,959
"2824",56140,4,3,-1,959
"2825",56141,2,3,1,959
"2826",56142,2,3,1,959
"2827",56143,2,3,1,959
"2828",56144,2,3,1,959
"2829",56145,3,3,0,959
"2830",56146,3,3,0,959
"2831",56147,3,4,1,959
"2832",56148,3,4,1,959
"2833",56149,3,4,1,959
"2834",56150,3,4,1,959
"2835",56151,3,4,1,959
"2836",56152,3,4,1,959
"2837",56153,3,4,1,959
"2838",56154,3,4,1,959
"2839",56155,3,4,1,959
"2840",56156,3,4,1,959
"2841",56157,14,15,1,959
"2842",56158,24,27,3,959
"2843",56159,22,25,3,959
"2844",56160,12,15,3,959
"2845",56161,3,2,-1,959
"2846",56162,3,2,-1,959
"2847",56163,4,3,-1,959
"2848",56164,4,3,-1,959
"2849",56165,3,3,0,959
"2850",56166,3,3,0,959
"2851",56167,4,3,-1,959
"2852",56168,4,3,-1,959
"2853",56169,4,3,-1,959
"2854",56170,4,3,-1,959
"2855",56171,5,3,-2,959
"2856",56172,5,3,-2,959
"2857",56173,5,3,-2,959
"2858",56174,5,3,-2,959
"2859",56175,5,3,-2,959
"2860",56176,5,3,-2,959
"2861",56177,5,4,-1,959
"2862",56178,5,4,-1,959
"2863",56179,5,4,-1,959
"2864",56180,5,4,-1,959
"2865",56181,4,4,0,959
"2866",56182,4,4,0,959
"2867",56183,4,5,1,959
"2868",56184,4,5,1,959
"2869",56185,4,5,1,959
"2870",56186,4,4,0,959
"2871",56187,4,5,1,959
"2872",56188,4,5,1,959
"2873",56189,4,5,1,959
"2874",56190,4,5,1,959
"2875",56191,4,5,1,959
"2876",56192,4,5,1,959
"2877",56193,4,5,1,959
"2878",56194,4,5,1,959
"2879",56195,4,5,1,959
"2880",56196,4,5,1,959
"2881",56197,4,6,2,959
"2882",56857,4,3,-1,959
"2883",56858,4,3,-1,959
"2884",56859,4,3,-1,959
"2885",56860,4,3,-1,959
"2886",56861,2,3,1,959
"2887",56862,2,3,1,959
"2888",56863,2,3,1,959
"2889",56864,2,3,1,959
"2890",56865,2,3,1,959
"2891",56866,3,3,0,959
"2892",56867,3,3,0,959
"2893",56868,3,3,0,959
"2894",56869,3,3,0,959
"2895",56870,3,3,0,959
"2896",56871,3,3,0,959
"2897",56872,3,3,0,959
"2898",56873,3,3,0,959
"2899",56874,3,4,1,959
"2900",56875,3,4,1,959
"2901",56876,3,4,1,959
"2902",56877,3,4,1,959
"2903",56878,3,4,1,959
"2904",56879,3,4,1,959
"2905",56880,3,3,0,959
"2906",56881,3,2,-1,959
"2907",56882,3,2,-1,959
"2908",56883,4,3,-1,959
"2909",56884,4,3,-1,959
"2910",56885,3,3,0,959
"2911",56886,3,3,0,959
"2912",56887,3,3,0,959
"2913",56888,3,3,0,959
"2914",56889,3,3,0,959
"2915",56890,3,3,0,959
"2916",56891,4,3,-1,959
"2917",56892,5,3,-2,959
"2918",56893,5,3,-2,959
"2919",56894,5,3,-2,959
"2920",56895,4,3,-1,959
"2921",56896,4,3,-1,959
"2922",56897,4,4,0,959
"2923",56898,4,4,0,959
"2924",56899,4,4,0,959
"2925",56900,4,4,0,959
"2926",56901,4,4,0,959
"2927",56902,4,4,0,959
"2928",56903,4,5,1,959
"2929",56904,4,4,0,959
"2930",56905,4,4,0,959
"2931",56906,4,4,0,959
"2932",56907,4,5,1,959
"2933",56908,4,5,1,959
"2934",56909,4,5,1,959
"2935",56910,4,5,1,959
"2936",56911,4,5,1,959
"2937",56912,4,5,1,959
"2938",57578,4,3,-1,959
"2939",57579,4,3,-1,959
"2940",57580,4,3,-1,959
"2941",57581,3,3,0,959
"2942",57582,2,3,1,959
"2943",57583,2,3,1,959
"2944",57584,2,3,1,959
"2945",57585,2,3,1,959
"2946",57586,2,3,1,959
"2947",57587,2,3,1,959
"2948",57588,2,3,1,959
"2949",57589,2,3,1,959
"2950",57590,2,3,1,959
"2951",57591,2,3,1,959
"2952",57592,3,3,0,959
"2953",57593,3,3,0,959
"2954",57594,3,3,0,959
"2955",57595,3,3,0,959
"2956",57596,3,3,0,959
"2957",57597,3,4,1,959
"2958",57598,3,4,1,959
"2959",57599,3,4,1,959
"2960",57600,3,3,0,959
"2961",57601,3,3,0,959
"2962",57602,3,3,0,959
"2963",57603,3,3,0,959
"2964",57604,3,3,0,959
"2965",57605,3,3,0,959
"2966",57606,3,3,0,959
"2967",57607,3,4,1,959
"2968",57608,3,4,1,959
"2969",57609,4,4,0,959
"2970",57610,4,4,0,959
"2971",57611,4,4,0,959
"2972",57612,4,4,0,959
"2973",57613,4,4,0,959
"2974",57614,4,4,0,959
"2975",57615,4,4,0,959
"2976",57616,4,4,0,959
"2977",57617,4,4,0,959
"2978",57618,4,5,1,959
"2979",57619,4,5,1,959
"2980",57620,4,5,1,959
"2981",57621,4,5,1,959
"2982",57622,4,5,1,959
"2983",57623,4,5,1,959
"2984",57624,4,5,1,959
"2985",57625,5,5,0,959
"2986",57626,5,5,0,959
"2987",57627,5,5,0,959
"2988",57628,5,5,0,959
"2989",58300,4,3,-1,959
"2990",58301,3,3,0,959
"2991",58302,3,3,0,959
"2992",58303,2,3,1,959
"2993",58304,2,3,1,959
"2994",58305,2,3,1,959
"2995",58306,2,3,1,959
"2996",58307,3,3,0,959
"2997",58308,3,3,0,959
"2998",58309,3,3,0,959
"2999",58310,3,3,0,959
"3000",58311,3,3,0,959
"3001",58312,3,3,0,959
"3002",58313,3,3,0,959
"3003",58314,3,3,0,959
"3004",58315,3,3,0,959
"3005",58316,3,3,0,959
"3006",58317,4,3,-1,959
"3007",58318,4,3,-1,959
"3008",58319,3,3,0,959
"3009",58320,3,3,0,959
"3010",58321,3,3,0,959
"3011",58322,3,3,0,959
"3012",58323,3,3,0,959
"3013",58324,3,3,0,959
"3014",58325,3,3,0,959
"3015",58326,3,3,0,959
"3016",58327,3,4,1,959
"3017",58328,3,4,1,959
"3018",58329,4,4,0,959
"3019",58330,4,4,0,959
"3020",58331,4,4,0,959
"3021",58332,4,4,0,959
"3022",58333,4,4,0,959
"3023",58334,4,4,0,959
"3024",58335,4,4,0,959
"3025",58336,4,4,0,959
"3026",58337,4,4,0,959
"3027",58338,4,4,0,959
"3028",58339,4,4,0,959
"3029",58340,4,4,0,959
"3030",58341,4,5,1,959
"3031",58342,4,5,1,959
"3032",58343,5,5,0,959
"3033",58344,5,5,0,959
"3034",59022,3,3,0,959
"3035",59023,2,3,1,959
"3036",59024,2,3,1,959
"3037",59025,2,3,1,959
"3038",59026,2,3,1,959
"3039",59027,3,3,0,959
"3040",59028,3,3,0,959
"3041",59029,3,3,0,959
"3042",59030,3,3,0,959
"3043",59031,3,3,0,959
"3044",59032,3,3,0,959
"3045",59033,3,3,0,959
"3046",59034,3,3,0,959
"3047",59035,3,3,0,959
"3048",59036,3,3,0,959
"3049",59037,3,3,0,959
"3050",59038,3,3,0,959
"3051",59039,3,3,0,959
"3052",59040,3,3,0,959
"3053",59041,4,4,0,959
"3054",59042,4,4,0,959
"3055",59043,4,4,0,959
"3056",59044,4,4,0,959
"3057",59045,4,4,0,959
"3058",59046,4,4,0,959
"3059",59047,4,4,0,959
"3060",59048,4,4,0,959
"3061",59049,4,4,0,959
"3062",59050,4,4,0,959
"3063",59051,4,4,0,959
"3064",59052,4,4,0,959
"3065",59053,4,4,0,959
"3066",59054,4,4,0,959
"3067",59055,4,5,1,959
"3068",59056,4,5,1,959
"3069",59057,4,5,1,959
"3070",59058,5,5,0,959
"3071",59059,5,5,0,959
"3072",59750,3,3,0,959
"3073",59751,3,3,0,959
"3074",59752,3,3,0,959
"3075",59753,3,4,1,959
"3076",59754,3,4,1,959
"3077",59755,3,4,1,959
"3078",59756,3,4,1,959
"3079",59757,3,4,1,959
"3080",59758,3,4,1,959
"3081",59759,3,4,1,959
"3082",59760,3,4,1,959
"3083",59761,4,4,0,959
"3084",59762,4,4,0,959
"3085",59763,4,4,0,959
"3086",59764,4,4,0,959
"3087",59765,4,4,0,959
"3088",59766,4,4,0,959
"3089",59767,4,4,0,959
"3090",59768,4,4,0,959
"3091",59769,4,4,0,959
"3092",59770,4,4,0,959
"3093",59771,4,4,0,959
"3094",60474,3,4,1,959
"3095",60475,3,4,1,959
"3096",60476,3,4,1,959
"3097",60477,3,4,1,959
"3098",60478,3,4,1,959
"3099",60479,3,4,1,959
"3100",60480,3,4,1,959
"3101",60481,4,4,0,959
"3102",60482,4,4,0,959
"3103",60483,4,4,0,959
"3104",60484,4,4,0,959
"3105",60485,4,4,0,959
"3106",61200,4,4,0,959
"3107",49060,50,55,5,925
"3108",49061,9,20,11,925
"3109",49780,98,103,5,925
"3110",49781,95,100,5,925
"3111",50494,108,109,1,925
"3112",50494,108,109,1,925
"3113",50495,106,109,3,925
"3114",50496,107,108,1,925
"3115",50497,109,109,0,925
"3116",50497,109,109,0,925
"3117",50498,109,109,0,925
"3118",50498,109,109,0,925
"3119",50499,104,106,2,925
"3120",50499,104,106,2,925
"3121",50500,103,105,2,925
"3122",50501,49,66,17,925
"3123",51209,10,12,2,925
"3124",51210,10,12,2,925
"3125",51211,11,12,1,925
"3126",51212,19,20,1,925
"3127",51213,78,80,2,925
"3128",51214,108,109,1,925
"3129",51214,108,109,1,925
"3130",51215,106,109,3,925
"3131",51215,106,109,3,925
"3132",51216,106,109,3,925
"3133",51216,106,109,3,925
"3134",51217,107,108,1,925
"3135",51217,107,108,1,925
"3136",51218,106,108,2,925
"3137",51219,104,106,2,925
"3138",51220,103,105,2,925
"3139",51221,92,95,3,925
"3140",51923,5,10,5,925
"3141",51924,5,10,5,925
"3142",51925,6,10,4,925
"3143",51926,9,12,3,925
"3144",51927,13,16,3,925
"3145",51928,14,16,2,925
"3146",51929,15,17,2,925
"3147",51930,10,12,2,925
"3148",51931,11,12,1,925
"3149",51932,12,13,1,925
"3150",51933,45,50,5,925
"3151",51934,108,109,1,925
"3152",51935,103,105,2,925
"3153",51936,101,103,2,925
"3154",51937,102,103,1,925
"3155",51938,102,102,0,925
"3156",51939,105,106,1,925
"3157",51940,105,107,2,925
"3158",51941,92,98,6,925
"3159",51942,104,105,1,925
"3160",51943,103,104,1,925
"3161",51944,29,40,11,925
"3162",52643,5,10,5,925
"3163",52644,6,11,5,925
"3164",52645,6,10,4,925
"3165",52646,7,10,3,925
"3166",52647,9,12,3,925
"3167",52648,13,16,3,925
"3168",52649,15,17,2,925
"3169",52650,15,17,2,925
"3170",52651,12,14,2,925
"3171",52652,13,14,1,925
"3172",52653,13,14,1,925
"3173",52654,69,74,5,925
"3174",52655,109,110,1,925
"3175",52656,105,107,2,925
"3176",52657,105,108,3,925
"3177",52658,99,101,2,925
"3178",52659,106,107,1,925
"3179",52660,108,108,0,925
"3180",52661,106,108,2,925
"3181",52662,106,107,1,925
"3182",52663,63,64,1,925
"3183",52664,56,58,2,925
"3184",53363,6,11,5,925
"3185",53364,6,11,5,925
"3186",53365,6,10,4,925
"3187",53366,7,10,3,925
"3188",53367,7,10,3,925
"3189",53368,7,10,3,925
"3190",53369,7,10,3,925
"3191",53370,10,12,2,925
"3192",53371,10,12,2,925
"3193",53372,11,12,1,925
"3194",53373,11,12,1,925
"3195",53374,12,13,1,925
"3196",53375,19,20,1,925
"3197",53376,106,109,3,925
"3198",53377,109,112,3,925
"3199",53378,107,108,1,925
"3200",53379,101,102,1,925
"3201",53380,93,95,2,925
"3202",53381,108,109,1,925
"3203",53382,108,109,1,925
"3204",53383,104,105,1,925
"3205",53384,105,105,0,925
"3206",53385,32,41,9,925
"3207",53386,30,40,10,925
"3208",54084,6,10,4,925
"3209",54085,6,10,4,925
"3210",54086,7,10,3,925
"3211",54087,7,10,3,925
"3212",54088,7,10,3,925
"3213",54089,7,10,3,925
"3214",54090,7,10,3,925
"3215",54091,10,12,2,925
"3216",54092,16,17,1,925
"3217",54093,16,17,1,925
"3218",54094,11,12,1,925
"3219",54095,12,13,1,925
"3220",54096,14,15,1,925
"3221",54097,110,112,2,925
"3222",54098,111,112,1,925
"3223",54099,109,109,0,925
"3224",54100,88,88,0,925
"3225",54101,94,95,1,925
"3226",54102,108,108,0,925
"3227",54103,109,108,-1,925
"3228",54104,107,109,2,925
"3229",54105,106,107,1,925
"3230",54106,61,63,2,925
"3231",54805,8,11,3,925
"3232",54806,8,11,3,925
"3233",54807,8,11,3,925
"3234",54808,8,11,3,925
"3235",54809,8,11,3,925
"3236",54810,8,11,3,925
"3237",54811,8,11,3,925
"3238",54812,11,13,2,925
"3239",54813,12,14,2,925
"3240",54814,12,14,2,925
"3241",54815,12,13,1,925
"3242",54816,13,14,1,925
"3243",54817,14,15,1,925
"3244",54818,113,116,3,925
"3245",54819,114,117,3,925
"3246",54820,86,90,4,925
"3247",54821,98,92,-6,925
"3248",54822,106,107,1,925
"3249",54823,106,106,0,925
"3250",54824,108,109,1,925
"3251",54825,108,109,1,925
"3252",54826,60,63,3,925
"3253",55526,8,11,3,925
"3254",55527,8,11,3,925
"3255",55528,8,11,3,925
"3256",55529,8,11,3,925
"3257",55530,10,13,3,925
"3258",55531,10,13,3,925
"3259",55532,10,13,3,925
"3260",55533,11,13,2,925
"3261",55534,12,13,1,925
"3262",55535,12,13,1,925
"3263",55536,12,13,1,925
"3264",55537,13,13,0,925
"3265",55538,13,13,0,925
"3266",55539,14,14,0,925
"3267",55540,42,42,0,925
"3268",55541,90,87,-3,925
"3269",55542,106,100,-6,925
"3270",55543,104,97,-7,925
"3271",55544,111,109,-2,925
"3272",55545,108,108,0,925
"3273",55546,94,94,0,925
"3274",55547,54,59,5,925
"3275",56247,8,11,3,925
"3276",56248,8,11,3,925
"3277",56249,8,11,3,925
"3278",56250,8,11,3,925
"3279",56251,8,12,4,925
"3280",56252,8,12,4,925
"3281",56253,8,12,4,925
"3282",56254,9,12,3,925
"3283",56255,12,14,2,925
"3284",56256,12,14,2,925
"3285",56257,13,14,1,925
"3286",56258,17,18,1,925
"3287",56259,17,18,1,925
"3288",56260,17,18,1,925
"3289",56261,64,69,5,925
"3290",56262,89,90,1,925
"3291",56263,115,115,0,925
"3292",56264,109,111,2,925
"3293",56265,110,110,0,925
"3294",56266,109,107,-2,925
"3295",56267,105,102,-3,925
"3296",56268,102,102,0,925
"3297",56269,44,50,6,925
"3298",56270,44,45,1,925
"3299",56271,43,44,1,925
"3300",56968,8,11,3,925
"3301",56969,8,11,3,925
"3302",56970,8,11,3,925
"3303",56971,8,12,4,925
"3304",56972,10,14,4,925
"3305",56973,10,14,4,925
"3306",56974,10,14,4,925
"3307",56975,11,14,3,925
"3308",56976,12,14,2,925
"3309",56977,13,14,1,925
"3310",56978,13,14,1,925
"3311",56979,15,16,1,925
"3312",56980,15,16,1,925
"3313",56981,14,15,1,925
"3314",56982,16,16,0,925
"3315",56983,28,27,-1,925
"3316",56984,115,115,0,925
"3317",56985,114,113,-1,925
"3318",56986,99,100,1,925
"3319",56988,25,24,-1,925
"3320",56989,101,102,1,925
"3321",56990,109,114,5,925
"3322",56991,110,115,5,925
"3323",56992,13,12,-1,925
"3324",56993,13,12,-1,925
"3325",57690,10,13,3,925
"3326",57691,10,14,4,925
"3327",57692,10,14,4,925
"3328",57693,10,14,4,925
"3329",57694,14,17,3,925
"3330",57695,14,17,3,925
"3331",57696,12,15,3,925
"3332",57697,14,15,1,925
"3333",57698,13,14,1,925
"3334",57699,14,15,1,925
"3335",57700,14,15,1,925
"3336",57701,15,15,0,925
"3337",57702,15,16,1,925
"3338",57703,18,18,0,925
"3339",57704,21,21,0,925
"3340",57705,103,105,2,925
"3341",57706,113,116,3,925
"3342",57707,105,109,4,925
"3343",57708,44,45,1,925
"3344",57710,109,110,1,925
"3345",57711,113,114,1,925
"3346",57712,114,114,0,925
"3347",57713,104,101,-3,925
"3348",57714,47,47,0,925
"3349",58411,10,14,4,925
"3350",58412,10,14,4,925
"3351",58413,10,14,4,925
"3352",58414,10,14,4,925
"3353",58415,10,14,4,925
"3354",58416,10,14,4,925
"3355",58417,11,14,3,925
"3356",58418,13,15,2,925
"3357",58419,14,15,1,925
"3358",58420,14,15,1,925
"3359",58421,13,14,1,925
"3360",58422,13,14,1,925
"3361",58423,14,14,0,925
"3362",58424,14,14,0,925
"3363",58425,19,19,0,925
"3364",58426,88,91,3,925
"3365",58427,113,116,3,925
"3366",58428,109,111,2,925
"3367",58429,108,109,1,925
"3368",58430,52,52,0,925
"3369",58431,110,112,2,925
"3370",58432,115,116,1,925
"3371",58433,117,115,-2,925
"3372",58434,115,115,0,925
"3373",58435,86,88,2,925
"3374",59133,14,18,4,925
"3375",59134,14,18,4,925
"3376",59135,9,14,5,925
"3377",59136,9,14,5,925
"3378",59137,9,14,5,925
"3379",59138,11,14,3,925
"3380",59139,12,15,3,925
"3381",59140,13,15,2,925
"3382",59141,14,15,1,925
"3383",59142,13,14,1,925
"3384",59143,14,14,0,925
"3385",59144,14,14,0,925
"3386",59145,14,14,0,925
"3387",59146,18,18,0,925
"3388",59147,63,64,1,925
"3389",59148,106,105,-1,925
"3390",59149,120,116,-4,925
"3391",59150,117,116,-1,925
"3392",59151,117,118,1,925
"3393",59151,117,118,1,925
"3394",59152,110,113,3,925
"3395",59153,102,103,1,925
"3396",59154,114,113,-1,925
"3397",59855,14,17,3,925
"3398",59856,9,13,4,925
"3399",59857,9,13,4,925
"3400",59858,11,14,3,925
"3401",59859,11,14,3,925
"3402",59860,12,15,3,925
"3403",59861,14,15,1,925
"3404",59862,14,15,1,925
"3405",59863,15,15,0,925
"3406",59864,14,14,0,925
"3407",59865,14,14,0,925
"3408",59866,14,14,0,925
"3409",59867,20,20,0,925
"3410",59868,73,77,4,925
"3411",59868,73,77,4,925
"3412",59869,103,87,-16,925
"3413",59869,103,87,-16,925
"3414",59870,110,108,-2,925
"3415",59870,110,108,-2,925
"3416",59871,121,121,0,925
"3417",59871,121,121,0,925
"3418",59872,119,119,0,925
"3419",59873,116,116,0,925
"3420",59874,115,115,0,925
"3421",60577,8,12,4,925
"3422",60578,10,13,3,925
"3423",60579,12,14,2,925
"3424",60580,12,14,2,925
"3425",60581,12,14,2,925
"3426",60582,11,13,2,925
"3427",60583,12,13,1,925
"3428",60584,14,13,-1,925
"3429",60585,14,13,-1,925
"3430",60586,15,14,-1,925
"3431",60586,15,14,-1,925
"3432",60587,15,15,0,925
"3433",60587,15,15,0,925
"3434",60588,21,21,0,925
"3435",60588,21,21,0,925
"3436",60589,69,71,2,925
"3437",60590,94,96,2,925
"3438",61298,8,12,4,925
"3439",61299,10,13,3,925
"3440",61300,10,13,3,925
"3441",61301,11,13,2,925
"3442",61302,11,13,2,925
"3443",61303,11,13,2,925
"3444",61304,13,13,0,925
"3445",61304,13,13,0,925
"3446",61305,13,13,0,925
"3447",61305,13,13,0,925
"3448",61306,15,14,-1,925
"3449",61306,15,14,-1,925
"3450",61307,15,15,0,925
"3451",61308,17,17,0,925
"3452",62020,11,12,1,925
"3453",62021,11,12,1,925
"3454",62022,11,12,1,925
"3455",62022,11,12,1,925
"3456",62023,11,11,0,925
"3457",62023,11,11,0,925
"3458",62024,12,11,-1,925
"3459",62024,12,11,-1,925
"3460",62025,13,11,-2,925
"3461",59151,117,118,1,848
"3462",59154,114,113,-1,848
"3463",59155,113,112,-1,848
"3464",59156,96,95,-1,848
"3465",59868,73,77,4,848
"3466",59869,103,87,-16,848
"3467",59870,110,108,-2,848
"3468",59871,121,121,0,848
"3469",59872,119,119,0,848
"3470",59873,116,116,0,848
"3471",59874,115,115,0,848
"3472",59875,114,112,-2,848
"3473",59876,111,110,-1,848
"3474",60586,15,14,-1,848
"3475",60587,15,15,0,848
"3476",60588,21,21,0,848
"3477",60589,69,71,2,848
"3478",60590,94,96,2,848
"3479",60591,124,125,1,848
"3480",60592,112,110,-2,848
"3481",60595,111,111,0,848
"3482",60596,110,110,0,848
"3483",61304,13,13,0,848
"3484",61305,13,13,0,848
"3485",61306,15,14,-1,848
"3486",61307,15,15,0,848
"3487",61308,17,17,0,848
"3488",61309,21,23,2,848
"3489",61310,40,41,1,848
"3490",61311,124,122,-2,848
"3491",61312,118,116,-2,848
"3492",61314,0,0,0,848
"3493",61316,0,0,0,848
"3494",62022,11,12,1,848
"3495",62023,11,11,0,848
"3496",62024,12,11,-1,848
"3497",62025,13,11,-2,848
"3498",62026,15,12,-3,848
"3499",62027,14,14,0,848
"3500",62028,14,14,0,848
"3501",62029,16,17,1,848
"3502",62030,34,36,2,848
"3503",62031,117,111,-6,848
"3504",62032,125,122,-3,848
"3505",62033,119,117,-2,848
"3506",62742,11,12,1,848
"3507",62743,11,11,0,848
"3508",62744,11,11,0,848
"3509",62745,12,11,-1,848
"3510",62746,15,12,-3,848
"3511",62747,13,14,1,848
"3512",62748,14,14,0,848
"3513",62749,16,17,1,848
"3514",62750,21,22,1,848
"3515",62751,102,85,-17,848
"3516",62752,129,127,-2,848
"3517",62753,121,120,-1,848
"3518",63463,11,12,1,848
"3519",63464,11,12,1,848
"3520",63465,11,12,1,848
"3521",63466,13,13,0,848
"3522",63467,15,13,-2,848
"3523",63468,16,13,-3,848
"3524",63469,18,15,-3,848
"3525",63470,30,28,-2,848
"3526",63471,105,100,-5,848
"3527",63472,125,121,-4,848
"3528",63473,117,114,-3,848
"3529",64183,11,12,1,848
"3530",64184,11,12,1,848
"3531",64185,12,13,1,848
"3532",64186,13,13,0,848
"3533",64187,13,13,0,848
"3534",64188,16,13,-3,848
"3535",64189,16,14,-2,848
"3536",64190,22,20,-2,848
"3537",64191,72,69,-3,848
"3538",64192,122,117,-5,848
"3539",64193,115,112,-3,848
"3540",64903,11,12,1,848
"3541",64904,12,12,0,848
"3542",64905,11,13,2,848
"3543",64906,12,13,1,848
"3544",64907,13,13,0,848
"3545",64908,16,13,-3,848
"3546",64909,16,12,-4,848
"3547",64910,38,33,-5,848
"3548",64911,105,99,-6,848
"3549",64912,102,96,-6,848
"3550",65623,12,13,1,848
"3551",65624,13,12,-1,848
"3552",65625,12,13,1,848
"3553",65626,13,13,0,848
"3554",65627,15,13,-2,848
"3555",65628,17,13,-4,848
"3556",65629,17,12,-5,848
"3557",65630,30,26,-4,848
"3558",65631,111,104,-7,848
"3559",65632,104,99,-5,848
"3560",66342,13,12,-1,848
"3561",66343,13,12,-1,848
"3562",66344,14,12,-2,848
"3563",66345,14,12,-2,848
"3564",66346,14,12,-2,848
"3565",66347,14,14,0,848
"3566",66348,16,14,-2,848
"3567",66349,17,14,-3,848
"3568",66350,24,21,-3,848
"3569",66351,100,89,-11,848
"3570",66352,96,86,-10,848
"3571",67062,13,12,-1,848
"3572",67063,14,12,-2,848
"3573",67064,14,12,-2,848
"3574",67065,15,13,-2,848
"3575",67066,16,13,-3,848
"3576",67067,15,15,0,848
"3577",67068,15,14,-1,848
"3578",67069,17,14,-3,848
"3579",67070,24,21,-3,848
"3580",67071,109,100,-9,848
"3581",67072,101,96,-5,848
"3582",67782,11,11,0,848
"3583",67783,12,10,-2,848
"3584",67784,15,13,-2,848
"3585",67785,17,14,-3,848
"3586",67786,16,13,-3,848
"3587",67787,16,13,-3,848
"3588",67788,17,13,-4,848
"3589",67789,17,15,-2,848
"3590",67790,23,21,-2,848
"3591",67791,122,111,-11,848
"3592",67792,115,105,-10,848
"3593",68502,11,11,0,848
"3594",68503,12,10,-2,848
"3595",68504,15,12,-3,848
"3596",68505,16,13,-3,848
"3597",68506,16,13,-3,848
"3598",68507,16,13,-3,848
"3599",68508,17,13,-4,848
"3600",68509,17,15,-2,848
"3601",68510,23,21,-2,848
"3602",68511,109,96,-13,848
"3603",68512,102,92,-10,848
"3604",69222,13,13,0,848
"3605",69223,11,11,0,848
"3606",69224,12,11,-1,848
"3607",69225,15,14,-1,848
"3608",69226,17,15,-2,848
"3609",69227,17,15,-2,848
"3610",69228,17,14,-3,848
"3611",69229,18,15,-3,848
"3612",69230,24,21,-3,848
"3613",69231,81,73,-8,848
"3614",69232,80,72,-8,848
"3615",69943,14,13,-1,848
"3616",69944,14,13,-1,848
"3617",69945,16,15,-1,848
"3618",69946,17,15,-2,848
"3619",69947,16,14,-2,848
"3620",69948,17,14,-3,848
"3621",69949,17,15,-2,848
"3622",69950,18,15,-3,848
"3623",69951,116,105,-11,848
"3624",69952,115,105,-10,848
"3625",70663,14,12,-2,848
"3626",70664,14,13,-1,848
"3627",70665,15,13,-2,848
"3628",70666,15,14,-1,848
"3629",70667,15,14,-1,848
"3630",70668,13,12,-1,848
"3631",70669,17,14,-3,848
"3632",70670,20,17,-3,848
"3633",70671,109,102,-7,848
"3634",70672,108,102,-6,848
"3635",71383,14,12,-2,848
"3636",71384,14,13,-1,848
"3637",71385,17,15,-2,848
"3638",71386,17,16,-1,848
"3639",71387,17,16,-1,848
"3640",71388,16,15,-1,848
"3641",71389,19,16,-3,848
"3642",71390,22,19,-3,848
"3643",71391,103,92,-11,848
"3644",71392,102,93,-9,848
"3645",72103,13,10,-3,848
"3646",72104,13,10,-3,848
"3647",72105,13,11,-2,848
"3648",72106,14,11,-3,848
"3649",72107,14,11,-3,848
"3650",72108,14,11,-3,848
"3651",72109,15,11,-4,848
"3652",72110,22,18,-4,848
"3653",72111,33,26,-7,848
"3654",72112,111,97,-14,848
"3655",72113,109,94,-15,848
"3656",72823,13,10,-3,848
"3657",72824,13,10,-3,848
"3658",72825,13,11,-2,848
"3659",72826,14,11,-3,848
"3660",72827,14,11,-3,848
"3661",72828,15,11,-4,848
"3662",72829,15,11,-4,848
"3663",72830,18,13,-5,848
"3664",72831,20,15,-5,848
"3665",72832,44,34,-10,848
"3666",72833,42,34,-8,848
"3667",73544,12,10,-2,848
"3668",73545,13,11,-2,848
"3669",73546,14,11,-3,848
"3670",73547,15,11,-4,848
"3671",73548,15,11,-4,848
"3672",73549,16,10,-6,848
"3673",73550,16,10,-6,848
"3674",73551,16,10,-6,848
"3675",73552,33,25,-8,848
"3676",73553,129,109,-20,848
"3677",73554,119,102,-17,848
"3678",74264,12,10,-2,848
"3679",74265,13,11,-2,848
"3680",74266,13,11,-2,848
"3681",74267,15,11,-4,848
"3682",74268,15,11,-4,848
"3683",74269,16,10,-6,848
"3684",74270,16,10,-6,848
"3685",74271,16,10,-6,848
"3686",74272,16,10,-6,848
"3687",74273,87,71,-16,848
"3688",74274,135,115,-20,848
"3689",74275,114,98,-16,848
"3690",74276,107,96,-11,848
"3691",74985,13,10,-3,848
"3692",74986,13,11,-2,848
"3693",74987,15,10,-5,848
"3694",74988,15,10,-5,848
"3695",74989,16,10,-6,848
"3696",74990,16,10,-6,848
"3697",74991,16,11,-5,848
"3698",74992,16,11,-5,848
"3699",74993,18,12,-6,848
"3700",74994,125,111,-14,848
"3701",74995,140,126,-14,848
"3702",74996,133,120,-13,848
"3703",75705,13,10,-3,848
"3704",75706,13,11,-2,848
"3705",75707,15,10,-5,848
"3706",75708,15,10,-5,848
"3707",75709,15,10,-5,848
"3708",75710,16,10,-6,848
"3709",75711,16,11,-5,848
"3710",75712,16,11,-5,848
"3711",75713,17,11,-6,848
"3712",75714,32,21,-11,848
"3713",75715,128,113,-15,848
"3714",75716,122,109,-13,848
"3715",76426,13,10,-3,848
"3716",76427,13,11,-2,848
"3717",76428,14,11,-3,848
"3718",76429,15,11,-4,848
"3719",76430,17,11,-6,848
"3720",76431,16,10,-6,848
"3721",76432,16,10,-6,848
"3722",76433,18,10,-8,848
"3723",76434,20,13,-7,848
"3724",76435,44,36,-8,848
"3725",76436,136,122,-14,848
"3726",76437,135,119,-16,848
"3727",77147,13,11,-2,848
"3728",77148,14,11,-3,848
"3729",77149,14,10,-4,848
"3730",77150,14,10,-4,848
"3731",77151,16,10,-6,848
"3732",77152,16,10,-6,848
"3733",77153,18,10,-8,848
"3734",77154,18,10,-8,848
"3735",77155,21,14,-7,848
"3736",77156,88,70,-18,848
"3737",77157,88,69,-19,848
"3738",77867,12,9,-3,848
"3739",77868,12,10,-2,848
"3740",77869,15,10,-5,848
"3741",77870,15,10,-5,848
"3742",77871,17,10,-7,848
"3743",77872,18,10,-8,848
"3744",77873,19,11,-8,848
"3745",77874,19,11,-8,848
"3746",77875,21,15,-6,848
"3747",77876,29,24,-5,848
"3748",77877,63,52,-11,848
"3749",77878,62,51,-11,848
"3750",78588,13,9,-4,848
"3751",78589,14,10,-4,848
"3752",78590,15,10,-5,848
"3753",78591,17,10,-7,848
"3754",78592,19,10,-9,848
"3755",78593,19,11,-8,848
"3756",78594,19,11,-8,848
"3757",78595,19,12,-7,848
"3758",78596,21,15,-6,848
"3759",78597,89,72,-17,848
"3760",78598,114,95,-19,848
"3761",78599,110,89,-21,848
"3762",79309,16,11,-5,848
"3763",79310,16,12,-4,848
"3764",79311,17,12,-5,848
"3765",79312,18,12,-6,848
"3766",79313,19,12,-7,848
"3767",79314,18,12,-6,848
"3768",79315,18,13,-5,848
"3769",79316,18,13,-5,848
"3770",79317,66,58,-8,848
"3771",79318,87,77,-10,848
"3772",79319,86,75,-11,848
"3773",80030,15,11,-4,848
"3774",80031,15,12,-3,848
"3775",80032,17,12,-5,848
"3776",80033,17,12,-5,848
"3777",80034,18,12,-6,848
"3778",80035,18,13,-5,848
"3779",80036,18,13,-5,848
"3780",80037,18,13,-5,848
"3781",80038,40,32,-8,848
"3782",80039,120,103,-17,848
"3783",80040,164,140,-24,848
"3784",80041,166,139,-27,848
"3785",80042,150,149,-1,848
"3786",80043,142,144,2,848
"3787",80751,15,12,-3,848
"3788",80752,16,13,-3,848
"3789",80753,17,13,-4,848
"3790",80754,18,13,-5,848
"3791",80755,18,13,-5,848
"3792",80756,18,13,-5,848
"3793",80757,18,13,-5,848
"3794",80758,21,15,-6,848
"3795",80759,33,30,-3,848
"3796",80760,153,144,-9,848
"3797",80761,158,152,-6,848
"3798",80762,148,139,-9,848
"3799",80763,162,159,-3,848
"3800",80764,161,158,-3,848
"3801",80765,151,149,-2,848
"3802",81472,16,12,-4,848
"3803",81473,16,13,-3,848
"3804",81474,17,13,-4,848
"3805",81475,18,13,-5,848
"3806",81476,18,13,-5,848
"3807",81477,17,13,-4,848
"3808",81478,19,14,-5,848
"3809",81479,28,24,-4,848
"3810",81480,43,39,-4,848
"3811",81481,164,150,-14,848
"3812",81482,163,150,-13,848
"3813",81483,166,159,-7,848
"3814",81484,160,156,-4,848
"3815",81485,158,153,-5,848
"3816",81486,143,143,0,848
"3817",82192,16,12,-4,848
"3818",82193,15,12,-3,848
"3819",82194,15,13,-2,848
"3820",82195,16,13,-3,848
"3821",82196,17,13,-4,848
"3822",82197,17,16,-1,848
"3823",82198,19,16,-3,848
"3824",82199,20,16,-4,848
"3825",82200,37,35,-2,848
"3826",82201,80,66,-14,848
"3827",82202,140,134,-6,848
"3828",82203,163,159,-4,848
"3829",82204,160,156,-4,848
"3830",82205,81,82,1,848
"3831",82206,79,82,3,848
"3832",82913,15,12,-3,848
"3833",82914,15,13,-2,848
"3834",82915,15,13,-2,848
"3835",82916,16,13,-3,848
"3836",82917,15,14,-1,848
"3837",82918,18,14,-4,848
"3838",82919,18,14,-4,848
"3839",82920,27,24,-3,848
"3840",82921,53,47,-6,848
"3841",82922,79,69,-10,848
"3842",82923,79,67,-12,848
"3843",82924,58,50,-8,848
"3844",82925,34,39,5,848
"3845",83633,13,11,-2,848
"3846",83634,13,11,-2,848
"3847",83635,13,12,-1,848
"3848",83636,14,12,-2,848
"3849",83637,15,14,-1,848
"3850",83638,15,14,-1,848
"3851",83639,16,15,-1,848
"3852",83640,17,15,-2,848
"3853",83641,16,20,4,848
"3854",83642,23,26,3,848
"3855",83643,24,27,3,848
"3856",83644,23,26,3,848
"3857",84354,13,11,-2,848
"3858",84355,14,11,-3,848
"3859",84356,14,12,-2,848
"3860",84357,14,14,0,848
"3861",84358,15,14,-1,848
"3862",84359,15,14,-1,848
"3863",84360,15,14,-1,848
"3864",84361,13,17,4,848
"3865",84362,23,27,4,848
"3866",84363,26,30,4,848
"3867",84364,26,30,4,848
"3868",85076,13,11,-2,848
"3869",85077,13,12,-1,848
"3870",85078,12,12,0,848
"3871",85079,11,14,3,848
"3872",85080,12,14,2,848
"3873",85081,14,16,2,848
"3874",85082,15,18,3,848
